county,administered_date,total_doses,cumulative_total_doses,pfizer_doses,cumulative_pfizer_doses,moderna_doses,cumulative_moderna_doses,jj_doses,cumulative_jj_doses,partially_vaccinated,total_partially_vaccinated,fully_vaccinated,cumulative_fully_vaccinated,at_least_one_dose,cumulative_at_least_one_dose,california_flag
Nevada,2020-12-16,3,3,3,3,0,0,0,0,3,3,0,0,3,3,California
Nevada,2020-12-17,6,9,6,9,0,0,0,0,6,9,0,0,6,9,California
Nevada,2020-12-18,51,60,51,60,0,0,0,0,51,60,0,0,51,60,California
Nevada,2020-12-19,55,115,55,115,0,0,0,0,55,115,0,0,55,115,California
Nevada,2020-12-20,12,127,12,127,0,0,0,0,12,127,0,0,12,127,California
Nevada,2020-12-21,69,196,69,196,0,0,0,0,69,196,0,0,69,196,California
Nevada,2020-12-22,91,287,89,285,2,2,0,0,91,287,0,0,91,287,California
Nevada,2020-12-23,234,521,202,487,32,34,0,0,234,521,0,0,234,521,California
Nevada,2020-12-24,15,536,12,499,3,37,0,0,15,536,0,0,15,536,California
Nevada,2020-12-25,2,538,2,501,0,37,0,0,2,538,0,0,2,538,California
Nevada,2020-12-26,5,543,3,504,2,39,0,0,5,543,0,0,5,543,California
Nevada,2020-12-27,88,631,88,592,0,39,0,0,88,631,0,0,88,631,California
Nevada,2020-12-28,170,801,93,685,77,116,0,0,170,801,0,0,170,801,California
Nevada,2020-12-29,100,901,75,760,25,141,0,0,100,901,0,0,100,901,California
Nevada,2020-12-30,85,986,66,826,19,160,0,0,85,986,0,0,85,986,California
Nevada,2020-12-31,39,1025,9,835,30,190,0,0,39,1025,0,0,39,1025,California
Nevada,2021-01-01,1,1026,0,835,1,191,0,0,1,1026,0,0,1,1026,California
Nevada,2021-01-02,1,1027,1,836,0,191,0,0,1,1027,0,0,1,1027,California
Nevada,2021-01-03,128,1155,126,962,2,193,0,0,128,1155,0,0,128,1155,California
Nevada,2021-01-04,71,1226,47,1009,24,217,0,0,71,1226,0,0,71,1226,California
Nevada,2021-01-05,271,1497,130,1139,141,358,0,0,270,1495,1,1,270,1496,California
Nevada,2021-01-06,93,1590,44,1183,49,407,0,0,85,1572,8,9,85,1581,California
Nevada,2021-01-07,217,1807,43,1226,174,581,0,0,209,1776,6,15,210,1791,California
Nevada,2021-01-08,220,2027,127,1353,93,674,0,0,169,1894,51,66,169,1960,California
Nevada,2021-01-09,63,2090,56,1409,7,681,0,0,15,1861,48,114,15,1975,California
Nevada,2021-01-10,17,2107,9,1418,8,689,0,0,9,1862,8,122,9,1984,California
Nevada,2021-01-11,183,2290,130,1548,53,742,0,0,56,1791,127,249,56,2040,California
Nevada,2021-01-12,605,2895,457,2005,148,890,0,0,537,2260,68,317,537,2577,California
Nevada,2021-01-13,259,3154,144,2149,115,1005,0,0,123,2248,136,453,124,2701,California
Nevada,2021-01-14,228,3382,123,2272,105,1110,0,0,210,2441,17,470,210,2911,California
Nevada,2021-01-15,392,3774,170,2442,222,1332,0,0,294,2637,98,568,294,3205,California
Nevada,2021-01-16,292,4066,13,2455,279,1611,0,0,289,2923,3,571,289,3494,California
Nevada,2021-01-17,36,4102,32,2487,4,1615,0,0,33,2953,3,574,33,3527,California
Nevada,2021-01-18,148,4250,40,2527,108,1723,0,0,138,3081,10,584,138,3665,California
Nevada,2021-01-19,231,4481,82,2609,149,1872,0,0,213,3276,18,602,213,3878,California
Nevada,2021-01-20,258,4739,152,2761,106,1978,0,0,245,3508,13,615,245,4123,California
Nevada,2021-01-21,334,5073,207,2968,127,2105,0,0,321,3816,13,628,321,4444,California
Nevada,2021-01-22,339,5412,209,3177,130,2235,0,0,308,4093,31,659,308,4752,California
Nevada,2021-01-23,171,5583,104,3281,67,2302,0,0,171,4264,0,659,171,4923,California
Nevada,2021-01-24,104,5687,96,3377,8,2310,0,0,67,4294,37,696,67,4990,California
Nevada,2021-01-25,262,5949,135,3512,127,2437,0,0,201,4434,61,757,201,5191,California
Nevada,2021-01-26,395,6344,141,3653,254,2691,0,0,294,4627,101,858,294,5485,California
Nevada,2021-01-27,401,6745,238,3891,163,2854,0,0,377,4980,24,882,377,5862,California
Nevada,2021-01-28,450,7195,305,4196,145,2999,0,0,412,5354,38,920,412,6274,California
Nevada,2021-01-29,591,7786,389,4585,202,3201,0,0,569,5902,22,942,570,6844,California
Nevada,2021-01-30,230,8016,102,4687,128,3329,0,0,227,6126,3,945,227,7071,California
Nevada,2021-01-31,101,8117,85,4772,16,3345,0,0,101,6227,0,945,101,7172,California
Nevada,2021-02-01,290,8407,71,4843,219,3564,0,0,276,6489,14,959,276,7448,California
Nevada,2021-02-02,512,8919,169,5012,343,3907,0,0,319,6615,193,1152,319,7767,California
Nevada,2021-02-03,806,9725,566,5578,240,4147,0,0,753,7316,52,1204,753,8520,California
Nevada,2021-02-04,749,10474,399,5977,350,4497,0,0,501,7570,247,1451,501,9021,California
Nevada,2021-02-05,638,11112,361,6338,277,4774,0,0,455,7843,182,1633,455,9476,California
Nevada,2021-02-06,274,11386,84,6422,190,4964,0,0,248,8065,26,1659,248,9724,California
Nevada,2021-02-07,243,11629,188,6610,55,5019,0,0,189,8200,54,1713,189,9913,California
Nevada,2021-02-08,644,12273,407,7017,237,5256,0,0,546,8648,98,1811,546,10459,California
Nevada,2021-02-09,603,12876,339,7356,264,5520,0,0,466,8977,137,1948,466,10925,California
Nevada,2021-02-10,637,13513,320,7676,317,5837,0,0,410,9160,227,2175,410,11335,California
Nevada,2021-02-11,854,14367,499,8175,355,6192,0,0,532,9371,321,2496,532,11867,California
Nevada,2021-02-12,916,15283,430,8605,486,6678,0,0,606,9668,309,2805,606,12473,California
Nevada,2021-02-13,576,15859,230,8835,346,7024,0,0,383,9861,190,2995,383,12856,California
Nevada,2021-02-14,223,16082,117,8952,106,7130,0,0,193,10025,30,3025,194,13050,California
Nevada,2021-02-15,707,16789,442,9394,265,7395,0,0,544,10406,163,3188,544,13594,California
Nevada,2021-02-16,608,17397,199,9593,409,7804,0,0,449,10697,158,3346,449,14043,California
Nevada,2021-02-17,1169,18566,754,10347,415,8219,0,0,868,11264,301,3647,868,14911,California
Nevada,2021-02-18,992,19558,549,10896,443,8662,0,0,600,11473,391,4038,600,15511,California
Nevada,2021-02-19,918,20476,629,11525,289,8951,0,0,571,11697,347,4385,571,16082,California
Nevada,2021-02-20,270,20746,99,11624,171,9122,0,0,161,11749,109,4494,161,16243,California
Nevada,2021-02-21,72,20818,67,11691,5,9127,0,0,9,11695,63,4557,9,16252,California
Nevada,2021-02-22,483,21301,324,12015,159,9286,0,0,341,11894,142,4699,341,16593,California
Nevada,2021-02-23,433,21734,193,12208,240,9526,0,0,203,11870,227,4926,203,16796,California
Nevada,2021-02-24,462,22196,234,12442,228,9754,0,0,246,11902,216,5142,248,17044,California
Nevada,2021-02-25,826,23022,456,12898,370,10124,0,0,403,11884,421,5563,403,17447,California
Nevada,2021-02-26,1182,24204,867,13765,315,10439,0,0,392,11487,790,6353,393,17840,California
Nevada,2021-02-27,330,24534,109,13874,221,10660,0,0,163,11484,167,6520,164,18004,California
Nevada,2021-02-28,234,24768,141,14015,93,10753,0,0,101,11452,133,6653,101,18105,California
Nevada,2021-03-01,771,25539,395,14410,376,11129,0,0,330,11342,440,7093,330,18435,California
Nevada,2021-03-02,659,26198,249,14659,410,11539,0,0,455,11597,201,7294,456,18891,California
Nevada,2021-03-03,881,27079,476,15135,405,11944,0,0,429,11575,451,7745,429,19320,California
Nevada,2021-03-04,986,28065,602,15737,384,12328,0,0,390,11372,593,8338,390,19710,California
Nevada,2021-03-05,696,28761,404,16141,282,12610,10,10,315,11318,379,8717,325,20035,California
Nevada,2021-03-06,330,29091,111,16252,193,12803,26,36,122,11258,208,8925,148,20183,California
Nevada,2021-03-07,194,29285,108,16360,66,12869,20,56,52,11188,141,9066,71,20254,California
Nevada,2021-03-08,696,29981,526,16886,132,13001,38,94,317,11165,378,9444,355,20609,California
Nevada,2021-03-09,574,30555,281,17167,262,13263,31,125,338,11298,235,9679,368,20977,California
Nevada,2021-03-10,857,31412,574,17741,246,13509,37,162,273,11026,582,10261,310,21287,California
Nevada,2021-03-11,1032,32444,663,18404,342,13851,27,189,498,11020,531,10792,525,21812,California
Nevada,2021-03-12,1021,33465,664,19068,324,14175,33,222,418,10870,602,11394,452,22264,California
Nevada,2021-03-13,217,33682,53,19121,158,14333,6,228,95,10850,122,11516,102,22366,California
Nevada,2021-03-14,98,33780,19,19140,76,14409,3,231,25,10805,73,11589,28,22394,California
Nevada,2021-03-15,815,34595,438,19578,367,14776,10,241,332,10666,481,12070,342,22736,California
Nevada,2021-03-16,926,35521,426,20004,452,15228,48,289,597,10983,328,12398,645,23381,California
Nevada,2021-03-17,923,36444,386,20390,528,15756,9,298,504,11078,418,12816,513,23894,California
Nevada,2021-03-18,537,36981,325,20715,204,15960,8,306,278,11107,259,13075,288,24182,California
Nevada,2021-03-19,239,37220,122,20837,114,16074,3,309,88,11047,151,13226,91,24273,California
Sutter,2020-12-15,1,1,1,1,0,0,0,0,1,1,0,0,1,1,California
Sutter,2020-12-16,4,5,4,5,0,0,0,0,4,5,0,0,4,5,California
Sutter,2020-12-17,2,7,2,7,0,0,0,0,2,7,0,0,2,7,California
Sutter,2020-12-18,20,27,20,27,0,0,0,0,20,27,0,0,20,27,California
Sutter,2020-12-19,44,71,44,71,0,0,0,0,44,71,0,0,44,71,California
Sutter,2020-12-20,42,113,42,113,0,0,0,0,42,113,0,0,42,113,California
Sutter,2020-12-21,101,214,101,214,0,0,0,0,101,214,0,0,101,214,California
Sutter,2020-12-22,174,388,174,388,0,0,0,0,174,388,0,0,174,388,California
Sutter,2020-12-23,114,502,110,498,4,4,0,0,114,502,0,0,114,502,California
Sutter,2020-12-24,17,519,11,509,6,10,0,0,17,519,0,0,17,519,California
Sutter,2020-12-26,38,557,34,543,4,14,0,0,38,557,0,0,38,557,California
Sutter,2020-12-27,24,581,23,566,1,15,0,0,24,581,0,0,24,581,California
Sutter,2020-12-28,82,663,54,620,28,43,0,0,82,663,0,0,82,663,California
Sutter,2020-12-29,101,764,14,634,87,130,0,0,101,764,0,0,101,764,California
Sutter,2020-12-30,136,900,33,667,103,233,0,0,136,900,0,0,136,900,California
Sutter,2020-12-31,70,970,6,673,64,297,0,0,70,970,0,0,70,970,California
Sutter,2021-01-01,3,973,3,676,0,297,0,0,3,973,0,0,3,973,California
Sutter,2021-01-02,134,1107,133,809,1,298,0,0,134,1107,0,0,134,1107,California
Sutter,2021-01-03,1,1108,0,809,1,299,0,0,1,1108,0,0,1,1108,California
Sutter,2021-01-04,248,1356,140,949,108,407,0,0,248,1356,0,0,248,1356,California
Sutter,2021-01-05,99,1455,56,1005,43,450,0,0,97,1451,2,2,97,1453,California
Sutter,2021-01-06,206,1661,52,1057,154,604,0,0,201,1647,5,7,201,1654,California
Sutter,2021-01-07,249,1910,150,1207,99,703,0,0,240,1879,8,15,240,1894,California
Sutter,2021-01-08,145,2055,40,1247,105,808,0,0,128,1990,17,32,128,2022,California
Sutter,2021-01-09,44,2099,43,1290,1,809,0,0,3,1952,41,73,3,2025,California
Sutter,2021-01-10,402,2501,37,1327,365,1174,0,0,364,2279,37,110,364,2389,California
Sutter,2021-01-11,133,2634,115,1442,18,1192,0,0,26,2198,107,217,26,2415,California
Sutter,2021-01-12,201,2835,165,1607,36,1228,0,0,56,2109,145,362,56,2471,California
Sutter,2021-01-13,157,2992,95,1702,62,1290,0,0,70,2092,87,449,70,2541,California
Sutter,2021-01-14,145,3137,50,1752,95,1385,0,0,125,2197,20,469,125,2666,California
Sutter,2021-01-15,433,3570,131,1883,302,1687,0,0,418,2600,15,484,418,3084,California
Sutter,2021-01-16,390,3960,42,1925,348,2035,0,0,359,2929,30,514,359,3443,California
Sutter,2021-01-17,25,3985,23,1948,2,2037,0,0,9,2922,16,530,9,3452,California
Sutter,2021-01-18,116,4101,61,2009,55,2092,0,0,70,2946,46,576,70,3522,California
Sutter,2021-01-19,100,4201,40,2049,60,2152,0,0,76,2998,24,600,76,3598,California
Sutter,2021-01-20,255,4456,190,2239,65,2217,0,0,235,3213,20,620,235,3833,California
Sutter,2021-01-21,432,4888,263,2502,169,2386,0,0,413,3607,19,639,413,4246,California
Sutter,2021-01-22,265,5153,82,2584,183,2569,0,0,256,3854,9,648,256,4502,California
Sutter,2021-01-23,396,5549,40,2624,356,2925,0,0,370,4198,26,674,370,4872,California
Sutter,2021-01-24,17,5566,14,2638,3,2928,0,0,15,4211,2,676,15,4887,California
Sutter,2021-01-25,302,5868,196,2834,106,3034,0,0,149,4208,152,828,149,5036,California
Sutter,2021-01-26,237,6105,100,2934,137,3171,0,0,142,4256,94,922,142,5178,California
Sutter,2021-01-27,383,6488,252,3186,131,3302,0,0,318,4509,65,987,318,5496,California
Sutter,2021-01-28,522,7010,300,3486,222,3524,0,0,392,4771,130,1117,392,5888,California
Sutter,2021-01-29,397,7407,140,3626,257,3781,0,0,237,4848,160,1277,237,6125,California
Sutter,2021-01-30,780,8187,39,3665,741,4522,0,0,769,5606,11,1288,769,6894,California
Sutter,2021-01-31,27,8214,27,3692,0,4522,0,0,27,5633,0,1288,27,6921,California
Sutter,2021-02-01,161,8375,47,3739,114,4636,0,0,130,5732,31,1319,130,7051,California
Sutter,2021-02-02,240,8615,25,3764,215,4851,0,0,210,5912,30,1349,210,7261,California
Sutter,2021-02-03,443,9058,36,3800,407,5258,0,0,211,5891,232,1581,211,7472,California
Sutter,2021-02-04,666,9724,366,4166,300,5558,0,0,617,6459,49,1630,617,8089,California
Sutter,2021-02-05,279,10003,30,4196,249,5807,0,0,133,6446,146,1776,133,8222,California
Sutter,2021-02-06,730,10733,25,4221,705,6512,0,0,711,7138,19,1795,711,8933,California
Sutter,2021-02-07,22,10755,19,4240,3,6515,0,0,19,7154,3,1798,19,8952,California
Sutter,2021-02-08,131,10886,26,4266,105,6620,0,0,95,7213,36,1834,95,9047,California
Sutter,2021-02-09,247,11133,47,4313,200,6820,0,0,185,7336,62,1896,185,9232,California
Sutter,2021-02-10,650,11783,378,4691,272,7092,0,0,169,7025,480,2376,169,9401,California
Sutter,2021-02-11,592,12375,262,4953,330,7422,0,0,368,7169,224,2600,368,9769,California
Sutter,2021-02-12,616,12991,62,5015,554,7976,0,0,301,7155,315,2915,301,10070,California
Sutter,2021-02-13,899,13890,48,5063,851,8827,0,0,783,7822,116,3031,783,10853,California
Sutter,2021-02-14,87,13977,24,5087,63,8890,0,0,77,7889,10,3041,77,10930,California
Sutter,2021-02-15,190,14167,64,5151,126,9016,0,0,121,7941,69,3110,121,11051,California
Sutter,2021-02-16,280,14447,43,5194,237,9253,0,0,198,8058,81,3191,198,11249,California
Sutter,2021-02-17,824,15271,434,5628,390,9643,0,0,126,7486,698,3889,126,11375,California
Sutter,2021-02-18,700,15971,50,5678,650,10293,0,0,491,7769,208,4097,491,11866,California
Sutter,2021-02-19,658,16629,380,6058,278,10571,0,0,460,8033,196,4293,460,12326,California
Sutter,2021-02-20,580,17209,52,6110,528,11099,0,0,480,8413,100,4393,480,12806,California
Sutter,2021-02-21,26,17235,21,6131,5,11104,0,0,7,8401,19,4412,7,12813,California
Sutter,2021-02-22,197,17432,113,6244,84,11188,0,0,86,8376,111,4523,86,12899,California
Sutter,2021-02-23,217,17649,31,6275,186,11374,0,0,94,8347,123,4646,94,12993,California
Sutter,2021-02-24,952,18601,347,6622,605,11979,0,0,188,7773,762,5408,188,13181,California
Sutter,2021-02-25,764,19365,489,7111,275,12254,0,0,592,8196,169,5577,592,13773,California
Sutter,2021-02-26,349,19714,55,7166,294,12548,0,0,144,8137,203,5780,144,13917,California
Sutter,2021-02-27,802,20516,38,7204,764,13312,0,0,648,8631,154,5934,648,14565,California
Sutter,2021-02-28,75,20591,38,7242,37,13349,0,0,58,8672,17,5951,58,14623,California
Sutter,2021-03-01,233,20824,59,7301,174,13523,0,0,139,8717,94,6045,139,14762,California
Sutter,2021-03-02,312,21136,56,7357,256,13779,0,0,160,8725,152,6197,160,14922,California
Sutter,2021-03-03,1330,22466,506,7863,824,14603,0,0,614,8630,709,6906,614,15536,California
Sutter,2021-03-04,1213,23679,840,8703,373,14976,0,0,940,9304,268,7174,942,16478,California
Sutter,2021-03-05,304,23983,69,8772,234,15210,1,1,176,9353,128,7302,177,16655,California
Sutter,2021-03-06,593,24576,44,8816,545,15755,4,5,450,9664,143,7445,454,17109,California
Sutter,2021-03-07,62,24638,23,8839,38,15793,1,6,42,9687,20,7465,43,17152,California
Sutter,2021-03-08,175,24813,68,8907,95,15888,12,18,111,9747,63,7528,123,17275,California
Sutter,2021-03-09,363,25176,129,9036,222,16110,12,30,172,9741,190,7718,184,17459,California
Sutter,2021-03-10,1512,26688,654,9690,806,16916,52,82,476,9236,1033,8751,528,17987,California
Sutter,2021-03-11,834,27522,401,10091,418,17334,15,97,604,9627,228,8979,619,18606,California
Sutter,2021-03-12,471,27993,79,10170,326,17660,66,163,162,9548,308,9287,229,18835,California
Sutter,2021-03-13,828,28821,632,10802,180,17840,16,179,663,10063,164,9451,679,19514,California
Sutter,2021-03-14,82,28903,21,10823,51,17891,10,189,34,10059,48,9499,44,19558,California
Sutter,2021-03-15,299,29202,66,10889,186,18077,47,236,136,10080,162,9661,183,19741,California
Sutter,2021-03-16,319,29521,85,10974,188,18265,46,282,165,10138,153,9814,211,19952,California
Sutter,2021-03-17,1294,30815,519,11493,765,19030,10,292,247,9356,1039,10853,257,20209,California
Sutter,2021-03-18,457,31272,84,11577,297,19327,76,368,284,9544,172,11025,360,20569,California
Sutter,2021-03-19,129,31401,43,11620,80,19407,6,374,79,9580,49,11074,85,20654,California
Imperial,2020-12-16,1,1,1,1,0,0,0,0,1,1,0,0,1,1,California
Imperial,2020-12-17,4,5,4,5,0,0,0,0,4,5,0,0,4,5,California
Imperial,2020-12-18,11,16,11,16,0,0,0,0,11,16,0,0,11,16,California
Imperial,2020-12-20,2,18,2,18,0,0,0,0,2,18,0,0,2,18,California
Imperial,2020-12-21,186,204,186,204,0,0,0,0,186,204,0,0,186,204,California
Imperial,2020-12-22,241,445,239,443,2,2,0,0,241,445,0,0,241,445,California
Imperial,2020-12-23,212,657,211,654,1,3,0,0,211,656,0,0,211,656,California
Imperial,2020-12-24,5,662,5,659,0,3,0,0,5,661,0,0,5,661,California
Imperial,2020-12-26,1,663,0,659,1,4,0,0,1,662,0,0,1,662,California
Imperial,2020-12-27,62,725,0,659,62,66,0,0,62,724,0,0,62,724,California
Imperial,2020-12-28,214,939,114,773,100,166,0,0,214,938,0,0,214,938,California
Imperial,2020-12-29,188,1127,35,808,153,319,0,0,188,1126,0,0,188,1126,California
Imperial,2020-12-30,366,1493,49,857,317,636,0,0,366,1492,0,0,366,1492,California
Imperial,2020-12-31,199,1692,26,883,173,809,0,0,199,1691,0,0,199,1691,California
Imperial,2021-01-01,5,1697,5,888,0,809,0,0,5,1696,0,0,5,1696,California
Imperial,2021-01-02,4,1701,0,888,4,813,0,0,4,1700,0,0,4,1700,California
Imperial,2021-01-03,90,1791,0,888,90,903,0,0,90,1790,0,0,90,1790,California
Imperial,2021-01-04,84,1875,4,892,80,983,0,0,84,1874,0,0,84,1874,California
Imperial,2021-01-05,172,2047,13,905,159,1142,0,0,172,2046,0,0,172,2046,California
Imperial,2021-01-06,190,2237,25,930,165,1307,0,0,189,2234,1,1,189,2235,California
Imperial,2021-01-07,318,2555,9,939,309,1616,0,0,315,2546,3,4,315,2550,California
Imperial,2021-01-08,190,2745,50,989,140,1756,0,0,181,2718,9,13,181,2731,California
Imperial,2021-01-09,24,2769,21,1010,3,1759,0,0,24,2742,0,13,24,2755,California
Imperial,2021-01-10,1,2770,0,1010,1,1760,0,0,1,2743,0,13,1,2756,California
Imperial,2021-01-11,401,3171,243,1253,158,1918,0,0,172,2686,229,242,172,2928,California
Imperial,2021-01-12,404,3575,301,1554,103,2021,0,0,142,2567,261,503,142,3070,California
Imperial,2021-01-13,379,3954,131,1685,248,2269,0,0,280,2748,99,602,280,3350,California
Imperial,2021-01-14,261,4215,151,1836,110,2379,0,0,255,2998,5,607,255,3605,California
Imperial,2021-01-15,239,4454,181,2017,58,2437,0,0,232,3223,7,614,232,3837,California
Imperial,2021-01-16,77,4531,71,2088,6,2443,0,0,77,3300,0,614,77,3914,California
Imperial,2021-01-17,10,4541,2,2090,8,2451,0,0,10,3310,0,614,10,3924,California
Imperial,2021-01-18,1053,5594,402,2492,651,3102,0,0,955,4168,98,712,956,4880,California
Imperial,2021-01-19,168,5762,128,2620,40,3142,0,0,121,4242,47,759,121,5001,California
Imperial,2021-01-20,289,6051,193,2813,96,3238,0,0,252,4457,37,796,252,5253,California
Imperial,2021-01-21,416,6467,183,2996,233,3471,0,0,396,4833,20,816,396,5649,California
Imperial,2021-01-22,467,6934,189,3185,278,3749,0,0,458,5282,9,825,458,6107,California
Imperial,2021-01-23,1047,7981,290,3475,757,4506,0,0,1046,6327,1,826,1046,7153,California
Imperial,2021-01-24,11,7992,3,3478,8,4514,0,0,11,6338,0,826,11,7164,California
Imperial,2021-01-25,216,8208,6,3484,210,4724,0,0,37,6197,178,1004,37,7201,California
Imperial,2021-01-26,358,8566,182,3666,176,4900,0,0,216,6271,142,1146,216,7417,California
Imperial,2021-01-27,575,9141,163,3829,412,5312,0,0,241,6178,334,1480,241,7658,California
Imperial,2021-01-28,632,9773,158,3987,474,5786,0,0,524,6594,108,1588,524,8182,California
Imperial,2021-01-29,422,10195,295,4282,127,5913,0,0,373,6918,49,1637,373,8555,California
Imperial,2021-01-30,65,10260,27,4309,38,5951,0,0,48,6949,17,1654,48,8603,California
Imperial,2021-01-31,24,10284,6,4315,18,5969,0,0,23,6971,1,1655,23,8626,California
Imperial,2021-02-01,439,10723,57,4372,382,6351,0,0,229,6991,209,1864,229,8855,California
Imperial,2021-02-02,682,11405,53,4425,629,6980,0,0,501,7311,181,2045,501,9356,California
Imperial,2021-02-03,481,11886,49,4474,432,7412,0,0,289,7409,191,2236,289,9645,California
Imperial,2021-02-04,1754,13640,1207,5681,547,7959,0,0,1439,8535,314,2550,1440,11085,California
Imperial,2021-02-05,397,14037,240,5921,157,8116,0,0,163,8466,232,2782,163,11248,California
Imperial,2021-02-06,875,14912,838,6759,37,8153,0,0,838,9268,36,2818,838,12086,California
Imperial,2021-02-07,36,14948,11,6770,25,8178,0,0,35,9302,1,2819,35,12121,California
Imperial,2021-02-08,252,15200,42,6812,210,8388,0,0,184,9418,68,2887,184,12305,California
Imperial,2021-02-09,471,15671,145,6957,326,8714,0,0,314,9575,157,3044,314,12619,California
Imperial,2021-02-10,396,16067,53,7010,343,9057,0,0,108,9396,288,3332,109,12728,California
Imperial,2021-02-11,464,16531,262,7272,202,9259,0,0,94,9120,370,3702,94,12822,California
Imperial,2021-02-12,2113,18644,1401,8673,712,9971,0,0,1762,10533,350,4052,1763,14585,California
Imperial,2021-02-13,45,18689,20,8693,25,9996,0,0,38,10564,7,4059,38,14623,California
Imperial,2021-02-14,25,18714,12,8705,13,10009,0,0,22,10584,3,4062,23,14646,California
Imperial,2021-02-15,35,18749,11,8716,24,10033,0,0,26,10601,9,4071,26,14672,California
Imperial,2021-02-16,514,19263,269,8985,245,10278,0,0,295,10677,219,4290,295,14967,California
Imperial,2021-02-17,440,19703,289,9274,151,10429,0,0,86,10409,354,4644,86,15053,California
Imperial,2021-02-18,643,20346,315,9589,328,10757,0,0,149,10065,493,5137,149,15202,California
Imperial,2021-02-19,770,21116,383,9972,387,11144,0,0,197,9690,572,5709,197,15399,California
Imperial,2021-02-20,1037,22153,192,10164,845,11989,0,0,323,9300,713,6422,323,15722,California
Imperial,2021-02-21,550,22703,516,10680,34,12023,0,0,542,9834,8,6430,542,16264,California
Imperial,2021-02-22,809,23512,569,11249,240,12263,0,0,755,10535,54,6484,755,17019,California
Imperial,2021-02-23,890,24402,385,11634,505,12768,0,0,839,11324,51,6535,840,17859,California
Imperial,2021-02-24,687,25089,299,11933,388,13156,0,0,584,11807,102,6637,585,18444,California
Imperial,2021-02-25,808,25897,347,12280,461,13617,0,0,439,11881,368,7005,442,18886,California
Imperial,2021-02-26,1642,27539,1339,13619,303,13920,0,0,1485,13213,154,7159,1486,20372,California
Imperial,2021-02-27,932,28471,883,14502,49,13969,0,0,199,12679,733,7892,199,20571,California
Imperial,2021-02-28,83,28554,75,14577,8,13977,0,0,71,12738,12,7904,71,20642,California
Imperial,2021-03-01,510,29064,308,14885,202,14179,0,0,452,13135,57,7961,454,21096,California
Imperial,2021-03-02,681,29745,262,15147,419,14598,0,0,397,13251,284,8245,400,21496,California
Imperial,2021-03-03,849,30594,54,15201,795,15393,0,0,475,13362,371,8616,482,21978,California
Imperial,2021-03-04,682,31276,94,15295,588,15981,0,0,420,13546,260,8876,444,22422,California
Imperial,2021-03-05,2539,33815,1933,17228,606,16587,0,0,1251,13512,1285,10161,1251,23673,California
Imperial,2021-03-06,682,34497,236,17464,446,17033,0,0,638,14113,41,10202,642,24315,California
Imperial,2021-03-07,84,34581,48,17512,35,17068,1,1,58,14152,26,10228,65,24380,California
Imperial,2021-03-08,360,34941,310,17822,23,17091,27,28,315,14450,45,10273,343,24723,California
Imperial,2021-03-09,689,35630,317,18139,137,17228,235,263,406,14811,283,10556,644,25367,California
Imperial,2021-03-10,663,36293,309,18448,252,17480,102,365,296,14846,367,10923,402,25769,California
Imperial,2021-03-11,1699,37992,444,18892,1065,18545,190,555,1090,15537,609,11532,1300,27069,California
Imperial,2021-03-12,3482,41474,2390,21282,909,19454,183,738,1911,16063,1570,13102,2096,29165,California
Imperial,2021-03-13,970,42444,89,21371,663,20117,218,956,684,16683,284,13386,904,30069,California
Imperial,2021-03-14,138,42582,32,21403,95,20212,11,967,98,16753,40,13426,110,30179,California
Imperial,2021-03-15,677,43259,225,21628,197,20409,255,1222,374,17080,302,13728,629,30808,California
Imperial,2021-03-16,1056,44315,287,21915,339,20748,430,1652,527,17509,528,14256,957,31765,California
Imperial,2021-03-17,1321,45636,569,22484,630,21378,122,1774,806,17930,513,14769,934,32699,California
Imperial,2021-03-18,749,46385,563,23047,140,21518,46,1820,447,18123,302,15071,495,33194,California
Imperial,2021-03-19,800,47185,528,23575,269,21787,3,1823,567,18470,231,15302,578,33772,California
San Joaquin,2020-12-15,12,12,12,12,0,0,0,0,12,12,0,0,12,12,California
San Joaquin,2020-12-16,435,447,435,447,0,0,0,0,435,447,0,0,435,447,California
San Joaquin,2020-12-17,384,831,384,831,0,0,0,0,384,831,0,0,384,831,California
San Joaquin,2020-12-18,572,1403,547,1378,25,25,0,0,572,1403,0,0,572,1403,California
San Joaquin,2020-12-19,199,1602,199,1577,0,25,0,0,199,1602,0,0,199,1602,California
San Joaquin,2020-12-20,111,1713,111,1688,0,25,0,0,111,1713,0,0,111,1713,California
San Joaquin,2020-12-21,560,2273,555,2243,5,30,0,0,560,2273,0,0,560,2273,California
San Joaquin,2020-12-22,1047,3320,888,3131,159,189,0,0,1046,3319,0,0,1046,3319,California
San Joaquin,2020-12-23,1017,4337,950,4081,67,256,0,0,1017,4336,0,0,1017,4336,California
San Joaquin,2020-12-24,219,4556,192,4273,27,283,0,0,219,4555,0,0,219,4555,California
San Joaquin,2020-12-25,14,4570,14,4287,0,283,0,0,14,4569,0,0,14,4569,California
San Joaquin,2020-12-26,100,4670,28,4315,72,355,0,0,100,4669,0,0,100,4669,California
San Joaquin,2020-12-27,40,4710,29,4344,11,366,0,0,40,4709,0,0,40,4709,California
San Joaquin,2020-12-28,640,5350,440,4784,200,566,0,0,640,5349,0,0,640,5349,California
San Joaquin,2020-12-29,871,6221,737,5521,134,700,0,0,871,6220,0,0,871,6220,California
San Joaquin,2020-12-30,1042,7263,737,6258,305,1005,0,0,1042,7262,0,0,1042,7262,California
San Joaquin,2020-12-31,446,7709,199,6457,247,1252,0,0,448,7710,0,0,448,7710,California
San Joaquin,2021-01-01,16,7725,10,6467,6,1258,0,0,16,7726,0,0,16,7726,California
San Joaquin,2021-01-02,249,7974,227,6694,22,1280,0,0,248,7974,0,0,248,7974,California
San Joaquin,2021-01-03,34,8008,17,6711,17,1297,0,0,33,8006,1,1,33,8007,California
San Joaquin,2021-01-04,482,8490,340,7051,142,1439,0,0,479,8485,0,1,479,8486,California
San Joaquin,2021-01-05,1015,9505,707,7758,308,1747,0,0,847,9167,169,170,851,9337,California
San Joaquin,2021-01-06,1291,10796,780,8538,511,2258,0,0,928,9752,358,528,943,10280,California
San Joaquin,2021-01-07,1119,11915,713,9251,406,2664,0,0,797,10252,319,847,819,11099,California
San Joaquin,2021-01-08,1334,13249,946,10197,388,3052,0,0,802,10530,528,1375,806,11905,California
San Joaquin,2021-01-09,369,13618,295,10492,74,3126,0,0,240,10641,129,1504,240,12145,California
San Joaquin,2021-01-10,216,13834,110,10602,106,3232,0,0,166,10757,50,1554,166,12311,California
San Joaquin,2021-01-11,1562,15396,1356,11958,206,3438,0,0,919,11038,642,2196,923,13234,California
San Joaquin,2021-01-12,1510,16906,1074,13032,436,3874,0,0,755,11044,753,2949,759,13993,California
San Joaquin,2021-01-13,1463,18369,835,13867,628,4502,0,0,947,11476,518,3467,950,14943,California
San Joaquin,2021-01-14,1575,19944,903,14770,672,5174,0,0,1211,12360,332,3799,1216,16159,California
San Joaquin,2021-01-15,1555,21499,673,15443,882,6056,0,0,1309,13445,225,4024,1310,17469,California
San Joaquin,2021-01-16,1171,22670,193,15636,978,7034,0,0,1146,14567,25,4049,1147,18616,California
San Joaquin,2021-01-17,1638,24308,124,15760,1514,8548,0,0,1614,16160,24,4073,1617,20233,California
San Joaquin,2021-01-18,712,25020,240,16000,472,9020,0,0,590,16631,120,4193,591,20824,California
San Joaquin,2021-01-19,1860,26880,895,16895,965,9985,0,0,1151,17077,707,4900,1153,21977,California
San Joaquin,2021-01-20,2114,28994,1303,18198,811,10796,0,0,1437,17844,676,5576,1443,23420,California
San Joaquin,2021-01-21,1978,30972,931,19129,1047,11843,0,0,1556,18988,418,5994,1562,24982,California
San Joaquin,2021-01-22,1954,32926,957,20086,997,12840,0,0,1809,20659,142,6136,1813,26795,California
San Joaquin,2021-01-23,934,33860,404,20490,530,13370,0,0,663,21053,271,6407,665,27460,California
San Joaquin,2021-01-24,328,34188,130,20620,198,13568,0,0,308,21344,18,6425,309,27769,California
San Joaquin,2021-01-25,1981,36169,1163,21783,818,14386,0,0,1409,22184,571,6996,1411,29180,California
San Joaquin,2021-01-26,2173,38342,1156,22939,1017,15403,0,0,1537,23092,634,7630,1542,30722,California
San Joaquin,2021-01-27,1792,40134,806,23745,986,16389,0,0,1283,23880,506,8136,1294,32016,California
San Joaquin,2021-01-28,2117,42251,836,24581,1281,17670,0,0,1439,24647,677,8813,1444,33460,California
San Joaquin,2021-01-29,2250,44501,1138,25719,1112,18782,0,0,1874,26161,373,9186,1887,35347,California
San Joaquin,2021-01-30,2367,46868,324,26043,2043,20825,0,0,2193,28203,153,9339,2195,37542,California
San Joaquin,2021-01-31,1568,48436,178,26221,1390,22215,0,0,1494,29640,59,9398,1496,39038,California
San Joaquin,2021-02-01,2622,51058,1410,27631,1212,23427,0,0,1844,30715,773,10171,1848,40886,California
San Joaquin,2021-02-02,2686,53744,1240,28871,1446,24873,0,0,2055,32155,625,10796,2065,42951,California
San Joaquin,2021-02-03,3154,56898,1299,30170,1855,26728,0,0,2278,33567,870,11666,2282,45233,California
San Joaquin,2021-02-04,3533,60431,1799,31969,1734,28462,0,0,2718,35489,808,12474,2730,47963,California
San Joaquin,2021-02-05,3332,63763,1942,33911,1390,29852,0,0,2470,37106,860,13334,2477,50440,California
San Joaquin,2021-02-06,1129,64892,788,34699,341,30193,0,0,958,37896,171,13505,961,51401,California
San Joaquin,2021-02-07,604,65496,478,35177,126,30319,0,0,413,38126,184,13689,414,51815,California
San Joaquin,2021-02-08,1750,67246,1067,36244,683,31002,0,0,1448,39274,306,13995,1454,53269,California
San Joaquin,2021-02-09,2072,69318,1165,37409,907,31909,0,0,1615,40441,453,14448,1620,54889,California
San Joaquin,2021-02-10,2624,71942,1287,38696,1337,33246,0,0,1374,40617,1226,15674,1402,56291,California
San Joaquin,2021-02-11,2904,74846,1541,40237,1363,34609,0,0,1770,41298,1121,16795,1802,58093,California
San Joaquin,2021-02-12,2814,77660,1185,41422,1629,36238,0,0,1675,41857,1138,17933,1697,59790,California
San Joaquin,2021-02-13,2110,79770,395,41817,1715,37953,0,0,838,41440,1264,19197,847,60637,California
San Joaquin,2021-02-14,1871,81641,249,42066,1622,39575,0,0,671,40936,1192,20389,688,61325,California
San Joaquin,2021-02-15,1920,83561,808,42874,1112,40687,0,0,1151,41367,751,21140,1182,62507,California
San Joaquin,2021-02-16,3017,86578,1408,44282,1609,42296,0,0,1600,41600,1409,22549,1642,64149,California
San Joaquin,2021-02-17,3324,89902,1338,45620,1986,44282,0,0,1885,42116,1430,23979,1946,66095,California
San Joaquin,2021-02-18,3444,93346,1475,47095,1969,46251,0,0,1963,42659,1462,25441,2005,68100,California
San Joaquin,2021-02-19,4606,97952,2745,49840,1861,48112,0,0,2768,43807,1807,27248,2955,71055,California
San Joaquin,2021-02-20,1586,99538,599,50439,987,49099,0,0,1084,44408,501,27749,1102,72157,California
San Joaquin,2021-02-21,565,100103,417,50856,148,49247,0,0,370,44603,194,27943,389,72546,California
San Joaquin,2021-02-22,4038,104141,2983,53839,1055,50302,0,0,3025,46686,986,28929,3069,75615,California
San Joaquin,2021-02-23,4815,108956,3242,57081,1573,51875,0,0,3230,48440,1564,30493,3318,78933,California
San Joaquin,2021-02-24,6632,115588,4237,61318,2395,54270,0,0,4948,51775,1667,32160,5002,83935,California
San Joaquin,2021-02-25,7074,122662,4744,66062,2330,56600,0,0,4803,54474,2244,34404,4943,88878,California
San Joaquin,2021-02-26,5882,128544,3308,69370,2574,59174,0,0,4147,56985,1713,36117,4224,93102,California
San Joaquin,2021-02-27,5501,134045,1579,70949,3922,63096,0,0,2572,56723,2903,39020,2641,95743,California
San Joaquin,2021-02-28,2912,136957,1053,72002,1859,64955,0,0,1887,57618,1017,40037,1912,97655,California
San Joaquin,2021-03-01,4087,141044,1775,73777,2312,67267,0,0,2193,58093,1882,41919,2357,100012,California
San Joaquin,2021-03-02,4067,145111,1627,75404,2440,69707,0,0,2486,59092,1571,43490,2570,102582,California
San Joaquin,2021-03-03,5898,151009,3794,79198,2102,71809,2,2,4323,62001,1561,45051,4470,107052,California
San Joaquin,2021-03-04,4964,155973,2389,81587,2575,74384,0,2,3099,63544,1854,46905,3397,110449,California
San Joaquin,2021-03-05,4209,160182,1873,83460,2330,76714,6,8,2888,65304,1310,48215,3070,113519,California
San Joaquin,2021-03-06,3364,163546,2292,85752,951,77665,121,129,2801,67691,556,48771,2943,116462,California
San Joaquin,2021-03-07,1197,164743,537,86289,620,78285,40,169,935,68405,247,49018,961,117423,California
San Joaquin,2021-03-08,2739,167482,1119,87408,1543,79828,77,246,1846,69483,885,49903,1963,119386,California
San Joaquin,2021-03-09,4191,171673,1857,89265,2213,82041,121,367,2661,70805,1515,51418,2837,122223,California
San Joaquin,2021-03-10,4948,176621,2595,91860,2232,84273,121,488,3497,73015,1434,52852,3644,125867,California
San Joaquin,2021-03-11,4746,181367,2449,94309,2111,86384,186,674,2835,74196,1902,54754,3083,128950,California
San Joaquin,2021-03-12,6386,187753,3406,97715,2759,89143,221,895,3775,75818,2600,57354,4222,133172,California
San Joaquin,2021-03-13,2902,190655,1476,99191,1324,90467,102,997,2060,77252,835,58189,2269,135441,California
San Joaquin,2021-03-14,1629,192284,555,99746,913,91380,161,1158,886,77595,742,58931,1085,136526,California
San Joaquin,2021-03-15,6062,198346,3792,103538,2110,93490,160,1318,2999,77767,3056,61987,3228,139754,California
San Joaquin,2021-03-16,7006,205352,4365,107903,2589,96079,52,1370,3962,78776,3040,65027,4049,143803,California
San Joaquin,2021-03-17,7627,212979,5158,113061,2428,98507,41,1411,3969,79240,3640,68667,4104,147907,California
San Joaquin,2021-03-18,6570,219549,4171,117232,1987,100494,412,1823,2665,78648,3892,72559,3300,151207,California
San Joaquin,2021-03-19,3957,223506,2270,119502,1528,102022,159,1982,1629,78335,2323,74882,2010,153217,California
San Joaquin,2021-03-20,2,223508,2,119504,0,102022,0,1982,1,78335,1,74883,1,153218,California
San Luis Obispo,2020-12-16,4,4,4,4,0,0,0,0,4,4,0,0,4,4,California
San Luis Obispo,2020-12-17,196,200,196,200,0,0,0,0,196,200,0,0,196,200,California
San Luis Obispo,2020-12-18,223,423,223,423,0,0,0,0,223,423,0,0,223,423,California
San Luis Obispo,2020-12-19,164,587,164,587,0,0,0,0,164,587,0,0,164,587,California
San Luis Obispo,2020-12-20,215,802,215,802,0,0,0,0,215,802,0,0,215,802,California
San Luis Obispo,2020-12-21,552,1354,552,1354,0,0,0,0,552,1354,0,0,552,1354,California
San Luis Obispo,2020-12-22,307,1661,303,1657,4,4,0,0,307,1661,0,0,307,1661,California
San Luis Obispo,2020-12-23,683,2344,370,2027,313,317,0,0,683,2344,0,0,683,2344,California
San Luis Obispo,2020-12-24,195,2539,19,2046,176,493,0,0,195,2539,0,0,195,2539,California
San Luis Obispo,2020-12-25,2,2541,1,2047,1,494,0,0,2,2541,0,0,2,2541,California
San Luis Obispo,2020-12-26,90,2631,12,2059,78,572,0,0,90,2631,0,0,90,2631,California
San Luis Obispo,2020-12-27,75,2706,0,2059,75,647,0,0,75,2706,0,0,75,2706,California
San Luis Obispo,2020-12-28,878,3584,431,2490,447,1094,0,0,878,3584,0,0,878,3584,California
San Luis Obispo,2020-12-29,903,4487,502,2992,401,1495,0,0,903,4487,0,0,903,4487,California
San Luis Obispo,2020-12-30,1175,5662,682,3674,493,1988,0,0,1175,5662,0,0,1175,5662,California
San Luis Obispo,2020-12-31,106,5768,4,3678,102,2090,0,0,106,5768,0,0,106,5768,California
San Luis Obispo,2021-01-01,11,5779,7,3685,4,2094,0,0,11,5779,0,0,11,5779,California
San Luis Obispo,2021-01-02,31,5810,7,3692,24,2118,0,0,31,5810,0,0,31,5810,California
San Luis Obispo,2021-01-03,16,5826,6,3698,10,2128,0,0,16,5826,0,0,16,5826,California
San Luis Obispo,2021-01-04,674,6500,524,4222,150,2278,0,0,674,6500,0,0,674,6500,California
San Luis Obispo,2021-01-05,978,7478,760,4982,218,2496,0,0,976,7474,2,2,976,7476,California
San Luis Obispo,2021-01-06,726,8204,481,5463,245,2741,0,0,718,8185,7,9,718,8194,California
San Luis Obispo,2021-01-07,1128,9332,950,6413,178,2919,0,0,686,8429,442,451,686,8880,California
San Luis Obispo,2021-01-08,880,10212,804,7217,76,2995,0,0,511,8572,368,819,511,9391,California
San Luis Obispo,2021-01-09,206,10418,198,7415,8,3003,0,0,28,8422,178,997,28,9419,California
San Luis Obispo,2021-01-10,10,10428,7,7422,3,3006,0,0,6,8424,4,1001,6,9425,California
San Luis Obispo,2021-01-11,526,10954,476,7898,50,3056,0,0,264,8427,261,1262,264,9689,California
San Luis Obispo,2021-01-12,598,11552,380,8278,218,3274,0,0,320,8469,278,1540,320,10009,California
San Luis Obispo,2021-01-13,882,12434,254,8532,628,3902,0,0,643,8875,237,1777,643,10652,California
San Luis Obispo,2021-01-14,728,13162,241,8773,487,4389,0,0,603,9366,112,1889,603,11255,California
San Luis Obispo,2021-01-15,734,13896,292,9065,442,4831,0,0,556,9749,173,2062,556,11811,California
San Luis Obispo,2021-01-16,99,13995,81,9146,18,4849,0,0,94,9838,5,2067,94,11905,California
San Luis Obispo,2021-01-17,65,14060,60,9206,5,4854,0,0,65,9903,0,2067,65,11970,California
San Luis Obispo,2021-01-18,1370,15430,388,9594,982,5836,0,0,1108,10749,262,2329,1108,13078,California
San Luis Obispo,2021-01-19,1582,17012,417,10011,1165,7001,0,0,1175,11517,407,2736,1175,14253,California
San Luis Obispo,2021-01-20,1881,18893,598,10609,1283,8284,0,0,1291,12221,588,3324,1292,15545,California
San Luis Obispo,2021-01-21,1567,20460,466,11075,1101,9385,0,0,1196,13049,368,3692,1196,16741,California
San Luis Obispo,2021-01-22,1515,21975,508,11583,1007,10392,0,0,1201,13937,313,4005,1201,17942,California
San Luis Obispo,2021-01-23,309,22284,292,11875,17,10409,0,0,294,14216,15,4020,294,18236,California
San Luis Obispo,2021-01-24,244,22528,239,12114,5,10414,0,0,238,14448,6,4026,238,18474,California
San Luis Obispo,2021-01-25,2070,24598,606,12720,1464,11878,0,0,1242,14864,828,4854,1244,19718,California
San Luis Obispo,2021-01-26,1998,26596,702,13422,1296,13174,0,0,1132,15132,864,5718,1132,20850,California
San Luis Obispo,2021-01-27,1609,28205,276,13698,1333,14507,0,0,1147,15817,462,6180,1147,21997,California
San Luis Obispo,2021-01-28,1457,29662,318,14016,1139,15646,0,0,1195,16751,261,6441,1195,23192,California
San Luis Obispo,2021-01-29,1722,31384,674,14690,1048,16694,0,0,1440,17909,282,6723,1440,24632,California
San Luis Obispo,2021-01-30,30,31414,11,14701,19,16713,0,0,25,17930,4,6727,25,24657,California
San Luis Obispo,2021-01-31,30,31444,20,14721,10,16723,0,0,27,17954,3,6730,27,24684,California
San Luis Obispo,2021-02-01,1651,33095,698,15419,953,17676,0,0,1384,19071,267,6997,1384,26068,California
San Luis Obispo,2021-02-02,1890,34985,674,16093,1216,18892,0,0,1514,20209,376,7373,1514,27582,California
San Luis Obispo,2021-02-03,1700,36685,725,16818,975,19867,0,0,1289,21087,411,7784,1289,28871,California
San Luis Obispo,2021-02-04,1652,38337,799,17617,853,20720,0,0,1089,21613,563,8347,1089,29960,California
San Luis Obispo,2021-02-05,1592,39929,718,18335,874,21594,0,0,1048,22118,544,8891,1049,31009,California
San Luis Obispo,2021-02-06,159,40088,92,18427,67,21661,0,0,95,22149,64,8955,95,31104,California
San Luis Obispo,2021-02-07,143,40231,96,18523,47,21708,0,0,75,22156,68,9023,75,31179,California
San Luis Obispo,2021-02-08,849,41080,462,18985,387,22095,0,0,492,22292,356,9379,492,31671,California
San Luis Obispo,2021-02-09,1120,42200,446,19431,674,22769,0,0,539,22262,576,9955,546,32217,California
San Luis Obispo,2021-02-10,1421,43621,481,19912,940,23709,0,0,519,21885,899,10854,522,32739,California
San Luis Obispo,2021-02-11,1325,44946,838,20750,487,24196,0,0,652,21867,670,11524,652,33391,California
San Luis Obispo,2021-02-12,767,45713,352,21102,415,24611,0,0,405,21910,362,11886,405,33796,California
San Luis Obispo,2021-02-13,372,46085,109,21211,263,24874,0,0,278,22095,93,11979,278,34074,California
San Luis Obispo,2021-02-14,305,46390,41,21252,264,25138,0,0,269,22328,36,12015,269,34343,California
San Luis Obispo,2021-02-15,704,47094,133,21385,571,25709,0,0,451,22529,250,12265,451,34794,California
San Luis Obispo,2021-02-16,2934,50028,1187,22572,1747,27456,0,0,1333,22268,1594,13859,1333,36127,California
San Luis Obispo,2021-02-17,2748,52776,1220,23792,1528,28984,0,0,1019,21565,1722,15581,1019,37146,California
San Luis Obispo,2021-02-18,2801,55577,1439,25231,1362,30346,0,0,1136,21043,1658,17239,1136,38282,California
San Luis Obispo,2021-02-19,1436,57013,1318,26549,118,30464,0,0,1116,21841,319,17558,1117,39399,California
San Luis Obispo,2021-02-20,226,57239,79,26628,147,30611,0,0,195,22005,31,17589,195,39594,California
San Luis Obispo,2021-02-21,33,57272,30,26658,3,30614,0,0,22,22016,11,17600,22,39616,California
San Luis Obispo,2021-02-22,2398,59670,1853,28511,545,31159,0,0,1464,22546,934,18534,1464,41080,California
San Luis Obispo,2021-02-23,1849,61519,1740,30251,109,31268,0,0,1364,23426,484,19018,1364,42444,California
San Luis Obispo,2021-02-24,2626,64145,1286,31537,1340,32608,0,0,826,22454,1798,20816,826,43270,California
San Luis Obispo,2021-02-25,2028,66173,1150,32687,878,33486,0,0,1114,22660,909,21725,1115,44385,California
San Luis Obispo,2021-02-26,2582,68755,1122,33809,1460,34946,0,0,1289,22661,1288,23013,1289,45674,California
San Luis Obispo,2021-02-27,565,69320,343,34152,222,35168,0,0,522,23140,43,23056,522,46196,California
San Luis Obispo,2021-02-28,175,69495,70,34222,105,35273,0,0,144,23257,27,23083,144,46340,California
San Luis Obispo,2021-03-01,2869,72364,1782,36004,1086,36359,1,1,1969,24330,900,23983,1973,48313,California
San Luis Obispo,2021-03-02,2729,75093,1685,37689,1044,37403,0,1,1649,24900,1079,25062,1649,49962,California
San Luis Obispo,2021-03-03,2061,77154,292,37981,1769,39172,0,1,690,24222,1369,26431,691,50653,California
San Luis Obispo,2021-03-04,1941,79095,979,38960,962,40134,0,1,996,24275,943,27374,996,51649,California
San Luis Obispo,2021-03-05,2088,81183,883,39843,1136,41270,69,70,1144,24551,937,28311,1213,52862,California
San Luis Obispo,2021-03-06,799,81982,299,40142,404,41674,96,166,596,25034,203,28514,686,53548,California
San Luis Obispo,2021-03-07,202,82184,35,40177,91,41765,76,242,81,25071,120,28634,157,53705,California
San Luis Obispo,2021-03-08,2357,84541,712,40889,1401,43166,244,486,1311,25584,1046,29680,1559,55264,California
San Luis Obispo,2021-03-09,2698,87239,893,41782,1576,44742,229,715,1347,25812,1349,31029,1577,56841,California
San Luis Obispo,2021-03-10,2600,89839,984,42766,1438,46180,178,893,1384,26158,1216,32245,1562,58403,California
San Luis Obispo,2021-03-11,2631,92470,1109,43875,1247,47427,275,1168,1416,26638,1211,33456,1691,60094,California
San Luis Obispo,2021-03-12,2646,95116,1173,45048,1220,48647,253,1421,1301,26851,1343,34799,1556,61650,California
San Luis Obispo,2021-03-13,558,95674,227,45275,226,48873,105,1526,345,27087,213,35012,449,62099,California
San Luis Obispo,2021-03-14,315,95989,39,45314,171,49044,105,1631,80,27038,234,35246,185,62284,California
San Luis Obispo,2021-03-15,2757,98746,1053,46367,1612,50656,92,1723,1288,26951,1468,36714,1381,63665,California
San Luis Obispo,2021-03-16,2589,101335,1438,47805,1054,51710,97,1820,1265,26992,1321,38035,1362,65027,California
San Luis Obispo,2021-03-17,2733,104068,1189,48994,1326,53036,218,2038,1522,27525,1207,39242,1740,66767,California
San Luis Obispo,2021-03-18,1844,105912,1105,50099,573,53609,166,2204,683,27215,1160,40402,850,67617,California
San Luis Obispo,2021-03-19,1036,106948,760,50859,253,53862,23,2227,248,26700,788,41190,273,67890,California
San Bernardino,2020-12-15,12,12,12,12,0,0,0,0,12,12,0,0,12,12,California
San Bernardino,2020-12-16,108,120,108,120,0,0,0,0,108,120,0,0,108,120,California
San Bernardino,2020-12-17,2340,2460,2340,2460,0,0,0,0,2340,2460,0,0,2340,2460,California
San Bernardino,2020-12-18,3140,5600,3137,5597,3,3,0,0,3141,5601,0,0,3141,5601,California
San Bernardino,2020-12-19,1067,6667,1067,6664,0,3,0,0,1068,6669,0,0,1068,6669,California
San Bernardino,2020-12-20,1170,7837,1169,7833,1,4,0,0,1170,7839,0,0,1170,7839,California
San Bernardino,2020-12-21,2455,10292,2450,10283,5,9,0,0,2455,10294,0,0,2455,10294,California
San Bernardino,2020-12-22,2270,12562,2147,12430,123,132,0,0,2271,12565,0,0,2271,12565,California
San Bernardino,2020-12-23,2642,15204,1450,13880,1192,1324,0,0,2641,15206,0,0,2641,15206,California
San Bernardino,2020-12-24,1157,16361,586,14466,571,1895,0,0,1159,16365,0,0,1159,16365,California
San Bernardino,2020-12-25,75,16436,14,14480,61,1956,0,0,75,16440,0,0,75,16440,California
San Bernardino,2020-12-26,461,16897,253,14733,208,2164,0,0,461,16901,0,0,461,16901,California
San Bernardino,2020-12-27,343,17240,160,14893,183,2347,0,0,343,17244,0,0,343,17244,California
San Bernardino,2020-12-28,1551,18791,706,15599,845,3192,0,0,1552,18796,0,0,1552,18796,California
San Bernardino,2020-12-29,2206,20997,1041,16640,1165,4357,0,0,2205,21000,1,1,2205,21001,California
San Bernardino,2020-12-30,2887,23884,1460,18100,1427,5784,0,0,2888,23888,0,1,2888,23889,California
San Bernardino,2020-12-31,1345,25229,439,18539,906,6690,0,0,1343,25231,0,1,1343,25232,California
San Bernardino,2021-01-01,271,25500,148,18687,123,6813,0,0,270,25501,0,1,270,25502,California
San Bernardino,2021-01-02,474,25974,339,19026,135,6948,0,0,474,25975,0,1,474,25976,California
San Bernardino,2021-01-03,133,26107,86,19112,47,6995,0,0,133,26108,0,1,133,26109,California
San Bernardino,2021-01-04,2108,28215,1288,20400,820,7815,0,0,2107,28215,0,1,2107,28216,California
San Bernardino,2021-01-05,2327,30542,1458,21858,869,8684,0,0,2213,30319,109,110,2213,30429,California
San Bernardino,2021-01-06,3411,33953,2345,24203,1066,9750,0,0,2925,32766,480,590,2927,33356,California
San Bernardino,2021-01-07,5363,39316,4476,28679,887,10637,0,0,2446,32316,2897,3487,2447,35803,California
San Bernardino,2021-01-08,5345,44661,4436,33115,909,11546,0,0,2270,31518,3070,6557,2272,38075,California
San Bernardino,2021-01-09,1393,46054,1097,34212,296,11842,0,0,899,31923,494,7051,899,38974,California
San Bernardino,2021-01-10,1011,47065,600,34812,411,12253,0,0,562,32037,448,7499,562,39536,California
San Bernardino,2021-01-11,4978,52043,4083,38895,895,13148,0,0,2761,32584,2214,9713,2761,42297,California
San Bernardino,2021-01-12,4212,56255,3219,42114,993,14141,0,0,2499,33371,1712,11425,2499,44796,California
San Bernardino,2021-01-13,4534,60789,2839,44953,1695,15836,0,0,3309,35470,1212,12637,3311,48107,California
San Bernardino,2021-01-14,4719,65508,2769,47722,1950,17786,0,0,4141,39037,574,13211,4141,52248,California
San Bernardino,2021-01-15,5915,71423,2954,50676,2961,20747,0,0,5521,44176,384,13595,5523,57771,California
San Bernardino,2021-01-16,2247,73670,1292,51968,955,21702,0,0,2106,46141,141,13736,2106,59877,California
San Bernardino,2021-01-17,1181,74851,513,52481,668,22370,0,0,1094,47149,86,13822,1094,60971,California
San Bernardino,2021-01-18,4252,79103,2630,55111,1622,23992,0,0,3634,50167,617,14439,3635,64606,California
San Bernardino,2021-01-19,6240,85343,3678,58789,2562,26554,0,0,5152,54236,1086,15525,5155,69761,California
San Bernardino,2021-01-20,6783,92126,3723,62512,3060,29614,0,0,4855,57173,1920,17445,4857,74618,California
San Bernardino,2021-01-21,5974,98100,3080,65592,2894,32508,0,0,4855,60919,1110,18555,4856,79474,California
San Bernardino,2021-01-22,6475,104575,3035,68627,3440,35948,0,0,5751,65950,723,19278,5754,85228,California
San Bernardino,2021-01-23,3097,107672,1888,70515,1209,37157,0,0,2708,68270,388,19666,2708,87936,California
San Bernardino,2021-01-24,1190,108862,459,70974,731,37888,0,0,1091,69262,99,19765,1091,89027,California
San Bernardino,2021-01-25,6832,115694,3389,74363,3443,41331,0,0,4997,72434,1833,21598,5005,94032,California
San Bernardino,2021-01-26,7060,122754,3550,77913,3510,44841,0,0,4994,75362,2066,23664,4994,99026,California
San Bernardino,2021-01-27,8201,130955,4091,82004,4110,48951,0,0,5515,78201,2676,26340,5515,104541,California
San Bernardino,2021-01-28,8454,139409,4014,86018,4440,53391,0,0,6168,82087,2282,28622,6168,110709,California
San Bernardino,2021-01-29,8077,147486,3722,89740,4355,57746,0,0,6143,86310,1921,30543,6144,116853,California
San Bernardino,2021-01-30,3062,150548,1891,91631,1171,58917,0,0,2784,88817,277,30820,2784,119637,California
San Bernardino,2021-01-31,925,151473,488,92119,437,59354,0,0,872,89637,52,30872,872,120509,California
San Bernardino,2021-02-01,7410,158883,4195,96314,3215,62569,0,0,4809,91852,2598,33470,4813,125322,California
San Bernardino,2021-02-02,10245,169128,3638,99952,6607,69176,0,0,8209,98028,2033,35503,8209,133531,California
San Bernardino,2021-02-03,8911,178039,4127,104079,4784,73960,0,0,6457,102039,2447,37950,6458,139989,California
San Bernardino,2021-02-04,10522,188561,5273,109352,5249,79209,0,0,7475,106477,3038,40988,7476,147465,California
San Bernardino,2021-02-05,10904,199465,5902,115254,5002,84211,0,0,7400,110384,3494,44482,7401,154866,California
San Bernardino,2021-02-06,5224,204689,2204,117458,3020,87231,0,0,3596,112379,1603,46085,3598,158464,California
San Bernardino,2021-02-07,841,205530,489,117947,352,87583,0,0,487,112516,351,46436,488,158952,California
San Bernardino,2021-02-08,6995,212525,3689,121636,3306,90889,0,0,5474,116470,1520,47956,5474,164426,California
San Bernardino,2021-02-09,9775,222300,5765,127401,4010,94899,0,0,6630,119959,3143,51099,6632,171058,California
San Bernardino,2021-02-10,11875,234175,6517,133918,5358,100257,0,0,7774,123643,4091,55190,7775,178833,California
San Bernardino,2021-02-11,11729,245904,6796,140714,4933,105190,0,0,7444,126824,4264,59454,7445,186278,California
San Bernardino,2021-02-12,10225,256129,5884,146598,4341,109531,0,0,5624,127860,4588,64042,5624,191902,California
San Bernardino,2021-02-13,5975,262104,3969,150567,2006,111537,0,0,3762,129426,2198,66240,3764,195666,California
San Bernardino,2021-02-14,1536,263640,643,151210,893,112430,0,0,865,129629,663,66903,866,196532,California
San Bernardino,2021-02-15,5442,269082,2995,154205,2447,114877,0,0,3056,130315,2371,69274,3057,199589,California
San Bernardino,2021-02-16,12259,281341,7193,161398,5066,119943,0,0,7740,133545,4510,73784,7740,207329,California
San Bernardino,2021-02-17,10538,291879,6180,167578,4358,124301,0,0,6487,135996,4038,77822,6489,213818,California
San Bernardino,2021-02-18,11782,303661,7286,174864,4496,128797,0,0,7329,138887,4439,82261,7330,221148,California
San Bernardino,2021-02-19,10969,314630,5553,180417,5416,134213,0,0,6578,141092,4374,86635,6579,227727,California
San Bernardino,2021-02-20,3985,318615,3222,183639,763,134976,0,0,1893,140894,2091,88726,1893,229620,California
San Bernardino,2021-02-21,782,319397,345,183984,437,135413,0,0,238,140590,542,89268,238,229858,California
San Bernardino,2021-02-22,8278,327675,5082,189066,3196,138609,0,0,3968,140256,4303,93571,3969,233827,California
San Bernardino,2021-02-23,8405,336080,5029,194095,3376,141985,0,0,4381,140645,3996,97567,4385,238212,California
San Bernardino,2021-02-24,11187,347267,6329,200424,4858,146843,0,0,5763,141007,5406,102973,5768,243980,California
San Bernardino,2021-02-25,11877,359144,6141,206565,5736,152579,0,0,6996,143141,4865,107838,6999,250979,California
San Bernardino,2021-02-26,12449,371593,6082,212647,6367,158946,0,0,7182,145106,5219,113057,7184,258163,California
San Bernardino,2021-02-27,6425,378018,3581,216228,2844,161790,0,0,4688,148071,1726,114783,4691,262854,California
San Bernardino,2021-02-28,1614,379632,666,216894,948,162738,0,0,1054,148571,555,115338,1055,263909,California
San Bernardino,2021-03-01,7275,386907,3567,220461,3708,166446,0,0,3631,148578,3629,118967,3636,267545,California
San Bernardino,2021-03-02,12899,399806,5160,225621,7739,174185,0,0,6178,148059,6699,125666,6180,273725,California
San Bernardino,2021-03-03,11710,411516,5964,231585,5744,179929,2,2,5382,147134,6311,131977,5386,279111,California
San Bernardino,2021-03-04,10774,422290,6014,237599,4760,184689,0,2,5189,146756,5570,137547,5192,284303,California
San Bernardino,2021-03-05,11462,433752,5938,243537,5523,190212,1,3,6080,147478,5363,142910,6085,290388,California
San Bernardino,2021-03-06,7585,441337,4149,247686,3232,193444,204,207,3637,147385,3937,146847,3844,294232,California
San Bernardino,2021-03-07,1472,442809,910,248596,506,193950,56,263,940,147851,530,147377,996,295228,California
San Bernardino,2021-03-08,6394,449203,2815,251411,3487,197437,92,355,3119,147792,3273,150650,3214,298442,California
San Bernardino,2021-03-09,11471,460674,6385,257796,4867,202304,219,574,4683,145917,6782,157432,4907,303349,California
San Bernardino,2021-03-10,12121,472795,6949,264745,4813,207117,359,933,5659,145499,6440,163872,6022,309371,California
San Bernardino,2021-03-11,12676,485471,5971,270716,5979,213096,726,1659,6654,146889,6003,169875,7393,316764,California
San Bernardino,2021-03-12,12900,498371,5962,276678,5304,218400,1634,3293,6437,148519,6447,176322,8077,324841,California
San Bernardino,2021-03-13,6966,505337,3954,280632,2763,221163,249,3542,4267,150341,2694,179016,4516,329357,California
San Bernardino,2021-03-14,2553,507890,1359,281991,730,221893,464,4006,1564,151383,985,180001,2027,331384,California
San Bernardino,2021-03-15,10841,518731,5071,287062,3882,225775,1888,5894,5394,153221,5442,185443,7280,338664,California
San Bernardino,2021-03-16,15296,534027,7571,294633,6931,232706,794,6688,9449,157639,5828,191271,10246,348910,California
San Bernardino,2021-03-17,10958,544985,5300,299933,5135,237841,523,7211,7690,162593,3259,194530,8213,357123,California
San Bernardino,2021-03-18,8363,553348,4089,304022,4058,241899,216,7427,4807,164074,3542,198072,5023,362146,California
San Bernardino,2021-03-19,5220,558568,2344,306366,2777,244676,99,7526,3057,165079,2158,200230,3163,365309,California
Sacramento,2020-12-15,312,312,312,312,0,0,0,0,312,312,0,0,312,312,California
Sacramento,2020-12-16,644,956,644,956,0,0,0,0,644,956,0,0,644,956,California
Sacramento,2020-12-17,647,1603,647,1603,0,0,0,0,647,1603,0,0,647,1603,California
Sacramento,2020-12-18,970,2573,967,2570,3,3,0,0,970,2573,0,0,970,2573,California
Sacramento,2020-12-19,615,3188,615,3185,0,3,0,0,615,3188,0,0,615,3188,California
Sacramento,2020-12-20,631,3819,631,3816,0,3,0,0,631,3819,0,0,631,3819,California
Sacramento,2020-12-21,1671,5490,1670,5486,1,4,0,0,1672,5491,0,0,1672,5491,California
Sacramento,2020-12-22,2095,7585,2066,7552,29,33,0,0,2095,7586,0,0,2095,7586,California
Sacramento,2020-12-23,2237,9822,2075,9627,162,195,0,0,2237,9823,0,0,2237,9823,California
Sacramento,2020-12-24,1041,10863,831,10458,210,405,0,0,1041,10864,0,0,1041,10864,California
Sacramento,2020-12-25,1,10864,0,10458,1,406,0,0,1,10865,0,0,1,10865,California
Sacramento,2020-12-26,507,11371,290,10748,217,623,0,0,507,11372,0,0,507,11372,California
Sacramento,2020-12-27,348,11719,246,10994,102,725,0,0,348,11720,0,0,348,11720,California
Sacramento,2020-12-28,1895,13614,1317,12311,578,1303,0,0,1894,13613,1,1,1894,13614,California
Sacramento,2020-12-29,1939,15553,1183,13494,756,2059,0,0,1939,15552,0,1,1939,15553,California
Sacramento,2020-12-30,2550,18103,1460,14954,1090,3149,0,0,2551,18103,0,1,2551,18104,California
Sacramento,2020-12-31,1212,19315,690,15644,522,3671,0,0,1212,19315,0,1,1212,19316,California
Sacramento,2021-01-01,68,19383,60,15704,8,3679,0,0,68,19383,0,1,68,19384,California
Sacramento,2021-01-02,562,19945,360,16064,202,3881,0,0,562,19945,0,1,562,19946,California
Sacramento,2021-01-03,404,20349,217,16281,187,4068,0,0,404,20349,0,1,404,20350,California
Sacramento,2021-01-04,1959,22308,846,17127,1113,5181,0,0,1956,22303,2,3,1956,22306,California
Sacramento,2021-01-05,2192,24500,984,18111,1208,6389,0,0,1845,23801,348,351,1846,24152,California
Sacramento,2021-01-06,2718,27218,1625,19736,1093,7482,0,0,1942,24970,773,1124,1942,26094,California
Sacramento,2021-01-07,2816,30034,1507,21243,1309,8791,0,0,1951,26064,862,1986,1956,28050,California
Sacramento,2021-01-08,3277,33311,2086,23329,1191,9982,0,0,2246,27284,1028,3014,2248,30298,California
Sacramento,2021-01-09,1284,34595,798,24127,486,10468,0,0,895,27791,388,3402,895,31193,California
Sacramento,2021-01-10,1240,35835,711,24838,529,10997,0,0,770,28093,469,3871,771,31964,California
Sacramento,2021-01-11,4303,40138,2939,27777,1364,12361,0,0,2384,28560,1918,5789,2385,34349,California
Sacramento,2021-01-12,4382,44520,3017,30794,1365,13726,0,0,2424,29028,1957,7746,2425,36774,California
Sacramento,2021-01-13,3735,48255,2159,32953,1576,15302,0,0,2321,29936,1413,9159,2321,39095,California
Sacramento,2021-01-14,4533,52788,2340,35293,2193,17495,0,0,3618,32642,912,10071,3618,42713,California
Sacramento,2021-01-15,4367,57155,2267,37560,2100,19595,0,0,3644,35567,722,10793,3647,46360,California
Sacramento,2021-01-16,2084,59239,1291,38851,793,20388,0,0,1867,37217,217,11010,1867,48227,California
Sacramento,2021-01-17,1623,60862,947,39798,676,21064,0,0,1446,38488,177,11187,1448,49675,California
Sacramento,2021-01-18,2841,63703,1759,41557,1082,22146,0,0,2320,40288,521,11708,2321,51996,California
Sacramento,2021-01-19,4563,68266,3040,44597,1523,23669,0,0,3308,42344,1255,12963,3311,55307,California
Sacramento,2021-01-20,4718,72984,2809,47406,1909,25578,0,0,3515,44657,1205,14168,3518,58825,California
Sacramento,2021-01-21,5104,78088,2964,50370,2140,27718,0,0,4148,47855,950,15118,4148,62973,California
Sacramento,2021-01-22,4926,83014,2629,52999,2297,30015,0,0,4622,52175,302,15420,4622,67595,California
Sacramento,2021-01-23,3710,86724,1549,54548,2161,32176,0,0,3256,54977,454,15874,3256,70851,California
Sacramento,2021-01-24,1509,88233,956,55504,553,32729,0,0,1272,56012,237,16111,1272,72123,California
Sacramento,2021-01-25,4312,92545,2100,57604,2212,34941,0,0,2900,57503,1412,17523,2903,75026,California
Sacramento,2021-01-26,4641,97186,2105,59709,2536,37477,0,0,3452,59771,1187,18710,3455,78481,California
Sacramento,2021-01-27,5756,102942,3021,62730,2735,40212,0,0,4171,62364,1581,20291,4174,82655,California
Sacramento,2021-01-28,5262,108204,2655,65385,2607,42819,0,0,4202,65508,1059,21350,4203,86858,California
Sacramento,2021-01-29,5278,113482,2912,68297,2366,45185,0,0,4265,68769,1007,22357,4268,91126,California
Sacramento,2021-01-30,4472,117954,2179,70476,2293,47478,0,0,4046,72389,426,22783,4046,95172,California
Sacramento,2021-01-31,2231,120185,1942,72418,289,47767,0,0,1953,74066,276,23059,1953,97125,California
Sacramento,2021-02-01,5835,126020,2968,75386,2867,50634,0,0,4201,76634,1634,24693,4202,101327,California
Sacramento,2021-02-02,6756,132776,3704,79090,3052,53686,0,0,4717,79319,2033,26726,4718,106045,California
Sacramento,2021-02-03,6891,139667,3517,82607,3374,57060,0,0,5053,82544,1830,28556,5055,111100,California
Sacramento,2021-02-04,7543,147210,3593,86200,3950,61010,0,0,5373,85757,2161,30717,5374,116474,California
Sacramento,2021-02-05,7464,154674,4280,90480,3184,64194,0,0,4704,87722,2739,33456,4704,121178,California
Sacramento,2021-02-06,8339,163013,3409,93889,4930,69124,0,0,7022,93431,1315,34771,7024,128202,California
Sacramento,2021-02-07,3883,166896,2012,95901,1871,70995,0,0,2675,94907,1201,35972,2677,130879,California
Sacramento,2021-02-08,6026,172922,3145,99046,2881,73876,0,0,3789,96465,2233,38205,3791,134670,California
Sacramento,2021-02-09,6632,179554,3476,102522,3156,77032,0,0,3873,97585,2754,40959,3874,138544,California
Sacramento,2021-02-10,7449,187003,4144,106666,3305,80337,0,0,4400,98950,3038,43997,4403,142947,California
Sacramento,2021-02-11,7862,194865,4285,110951,3577,83914,0,0,4087,99272,3765,47762,4087,147034,California
Sacramento,2021-02-12,10176,205041,4073,115024,6103,90017,0,0,6161,101453,3983,51745,6164,153198,California
Sacramento,2021-02-13,7245,212286,2932,117956,4313,94330,0,0,5706,105621,1538,53283,5706,158904,California
Sacramento,2021-02-14,2897,215183,1826,119782,1071,95401,0,0,1936,106603,958,54241,1940,160844,California
Sacramento,2021-02-15,5582,220765,1971,121753,3611,99012,0,0,3824,108682,1751,55992,3830,164674,California
Sacramento,2021-02-16,8562,229327,4054,125807,4508,103520,0,0,5102,110343,3454,59446,5115,169789,California
Sacramento,2021-02-17,8344,237671,4773,130580,3571,107091,0,0,4864,111757,3470,62916,4884,174673,California
Sacramento,2021-02-18,8169,245840,4530,135110,3639,110730,0,0,4569,112737,3593,66509,4573,179246,California
Sacramento,2021-02-19,9269,255109,5768,140878,3501,114231,0,0,5391,114340,3866,70375,5469,184715,California
Sacramento,2021-02-20,6979,262088,5091,145969,1888,116119,0,0,4015,115410,2959,73334,4029,188744,California
Sacramento,2021-02-21,2280,264368,1755,147724,525,116644,0,0,786,114721,1492,74826,803,189547,California
Sacramento,2021-02-22,5900,270268,3617,151341,2283,118927,0,0,2495,113829,3398,78224,2506,192053,California
Sacramento,2021-02-23,6685,276953,4290,155631,2395,121322,0,0,3313,113795,3358,81582,3324,195377,California
Sacramento,2021-02-24,8789,285742,4990,160621,3799,125121,0,0,4732,114497,4041,85623,4743,200120,California
Sacramento,2021-02-25,9076,294818,4980,165601,4096,129217,0,0,4828,115117,4237,89860,4857,204977,California
Sacramento,2021-02-26,12285,307103,6038,171639,6247,135464,0,0,8388,119647,3865,93725,8395,213372,California
Sacramento,2021-02-27,9388,316491,5587,177226,3801,139265,0,0,6686,123649,2687,96412,6689,220061,California
Sacramento,2021-02-28,5056,321547,1905,179131,3151,142416,0,0,2301,123205,2750,99162,2306,222367,California
Sacramento,2021-03-01,7358,328905,3220,182351,4138,146554,0,0,3849,123572,3492,102654,3859,226226,California
Sacramento,2021-03-02,8202,337107,3658,186009,4543,151097,1,1,5111,125611,3079,105733,5118,231344,California
Sacramento,2021-03-03,9074,346181,4481,190490,4592,155689,1,2,5321,127199,3737,109470,5325,236669,California
Sacramento,2021-03-04,9460,355641,4017,194507,5441,161130,2,4,5292,128365,4150,113620,5316,241985,California
Sacramento,2021-03-05,8109,363750,3628,198135,4453,165583,28,32,4983,130289,3111,116731,5035,247020,California
Sacramento,2021-03-06,6999,370749,2734,200869,4145,169728,120,152,3578,130584,3406,120137,3701,250721,California
Sacramento,2021-03-07,7342,378091,2106,202975,5153,174881,83,235,3564,130456,3774,123911,3646,254367,California
Sacramento,2021-03-08,7901,385992,3749,206724,3991,178872,161,396,5056,132841,2837,126748,5222,259589,California
Sacramento,2021-03-09,8914,394906,4256,210980,4417,183289,241,637,5190,134566,3712,130460,5437,265026,California
Sacramento,2021-03-10,10639,405545,7213,218193,3142,186431,284,921,6151,136528,4473,134933,6435,271461,California
Sacramento,2021-03-11,12659,418204,8194,226387,3778,190209,687,1608,7771,140119,4870,139803,8461,279922,California
Sacramento,2021-03-12,15345,433549,7365,233752,7232,197441,748,2356,7273,140120,8050,147853,8051,287973,California
Sacramento,2021-03-13,11774,445323,3391,237143,7995,205436,388,2744,7658,144076,4109,151962,8065,296038,California
Sacramento,2021-03-14,7283,452606,3079,240222,3600,209036,604,3348,4229,145876,3040,155002,4840,300878,California
Sacramento,2021-03-15,11043,463649,4648,244870,5802,214838,593,3941,6515,148482,4513,159515,7119,307997,California
Sacramento,2021-03-16,13240,476889,5961,250831,6652,221490,627,4568,8187,152266,5032,164547,8816,316813,California
Sacramento,2021-03-17,10024,486913,4969,255800,4590,226080,465,5033,6492,155717,3512,168059,6963,323776,California
Sacramento,2021-03-18,6545,493458,3133,258933,3144,229224,268,5301,4247,157956,2286,170345,4525,328301,California
Sacramento,2021-03-19,4880,498338,2196,261129,2236,231460,448,5749,2575,158697,2297,172642,3038,331339,California
Monterey,2020-12-16,4,4,4,4,0,0,0,0,4,4,0,0,4,4,California
Monterey,2020-12-17,81,85,81,85,0,0,0,0,81,85,0,0,81,85,California
Monterey,2020-12-18,481,566,481,566,0,0,0,0,481,566,0,0,481,566,California
Monterey,2020-12-19,579,1145,579,1145,0,0,0,0,579,1145,0,0,579,1145,California
Monterey,2020-12-20,422,1567,422,1567,0,0,0,0,422,1567,0,0,422,1567,California
Monterey,2020-12-21,721,2288,721,2288,0,0,0,0,721,2288,0,0,721,2288,California
Monterey,2020-12-22,535,2823,522,2810,13,13,0,0,535,2823,0,0,535,2823,California
Monterey,2020-12-23,433,3256,257,3067,176,189,0,0,433,3256,0,0,433,3256,California
Monterey,2020-12-24,82,3338,9,3076,73,262,0,0,82,3338,0,0,82,3338,California
Monterey,2020-12-25,6,3344,0,3076,6,268,0,0,6,3344,0,0,6,3344,California
Monterey,2020-12-26,92,3436,5,3081,87,355,0,0,92,3436,0,0,92,3436,California
Monterey,2020-12-27,6,3442,3,3084,3,358,0,0,6,3442,0,0,6,3442,California
Monterey,2020-12-28,478,3920,26,3110,452,810,0,0,478,3920,0,0,478,3920,California
Monterey,2020-12-29,901,4821,168,3278,733,1543,0,0,901,4821,0,0,901,4821,California
Monterey,2020-12-30,566,5387,97,3375,469,2012,0,0,566,5387,0,0,566,5387,California
Monterey,2020-12-31,34,5421,10,3385,24,2036,0,0,34,5421,0,0,34,5421,California
Monterey,2021-01-01,9,5430,2,3387,7,2043,0,0,9,5430,0,0,9,5430,California
Monterey,2021-01-02,136,5566,133,3520,3,2046,0,0,136,5566,0,0,136,5566,California
Monterey,2021-01-03,30,5596,29,3549,1,2047,0,0,30,5596,0,0,30,5596,California
Monterey,2021-01-04,412,6008,18,3567,394,2441,0,0,412,6008,0,0,412,6008,California
Monterey,2021-01-05,750,6758,324,3891,426,2867,0,0,736,6730,14,14,736,6744,California
Monterey,2021-01-06,654,7412,172,4063,482,3349,0,0,632,7340,22,36,632,7376,California
Monterey,2021-01-07,738,8150,568,4631,170,3519,0,0,416,7436,320,356,416,7792,California
Monterey,2021-01-08,1088,9238,736,5367,352,3871,0,0,394,7136,694,1050,394,8186,California
Monterey,2021-01-09,963,10201,935,6302,28,3899,0,0,313,6799,650,1700,313,8499,California
Monterey,2021-01-10,273,10474,270,6572,3,3902,0,0,7,6540,266,1966,7,8506,California
Monterey,2021-01-11,1059,11533,981,7553,78,3980,0,0,359,6199,700,2666,359,8865,California
Monterey,2021-01-12,461,11994,386,7939,75,4055,0,0,201,6140,260,2926,201,9066,California
Monterey,2021-01-13,1219,13213,592,8531,627,4682,0,0,1174,7269,45,2971,1174,10240,California
Monterey,2021-01-14,1044,14257,92,8623,952,5634,0,0,1026,8280,18,2989,1029,11269,California
Monterey,2021-01-15,1027,15284,38,8661,989,6623,0,0,1017,9287,10,2999,1017,12286,California
Monterey,2021-01-16,366,15650,300,8961,66,6689,0,0,360,9641,6,3005,360,12646,California
Monterey,2021-01-17,313,15963,291,9252,22,6711,0,0,300,9928,13,3018,300,12946,California
Monterey,2021-01-18,401,16364,50,9302,351,7062,0,0,380,10287,21,3039,380,13326,California
Monterey,2021-01-19,570,16934,393,9695,177,7239,0,0,413,10545,155,3194,413,13739,California
Monterey,2021-01-20,526,17460,267,9962,259,7498,0,0,322,10664,203,3397,322,14061,California
Monterey,2021-01-21,836,18296,90,10052,746,8244,0,0,727,11286,109,3506,731,14792,California
Monterey,2021-01-22,1015,19311,189,10241,826,9070,0,0,975,12222,40,3546,976,15768,California
Monterey,2021-01-23,237,19548,171,10412,66,9136,0,0,115,12216,121,3667,115,15883,California
Monterey,2021-01-24,58,19606,38,10450,20,9156,0,0,23,12204,35,3702,23,15906,California
Monterey,2021-01-25,779,20385,173,10623,606,9762,0,0,154,11741,618,4320,155,16061,California
Monterey,2021-01-26,917,21302,219,10842,698,10460,0,0,227,11278,690,5010,227,16288,California
Monterey,2021-01-27,856,22158,304,11146,552,11012,0,0,375,11172,481,5491,375,16663,California
Monterey,2021-01-28,1994,24152,724,11870,1270,12282,0,0,1665,12508,329,5820,1665,18328,California
Monterey,2021-01-29,1217,25369,699,12569,518,12800,0,0,1104,13501,112,5932,1105,19433,California
Monterey,2021-01-30,411,25780,264,12833,147,12947,0,0,180,13450,231,6163,180,19613,California
Monterey,2021-01-31,495,26275,74,12907,421,13368,0,0,482,13920,13,6176,483,20096,California
Monterey,2021-02-01,1648,27923,1141,14048,507,13875,0,0,1087,14447,560,6736,1087,21183,California
Monterey,2021-02-02,2139,30062,450,14498,1689,15564,0,0,1535,15378,604,7340,1535,22718,California
Monterey,2021-02-03,2327,32389,1048,15546,1279,16843,0,0,1554,16162,771,8111,1555,24273,California
Monterey,2021-02-04,2693,35082,2014,17560,679,17522,0,0,2437,18345,254,8365,2437,26710,California
Monterey,2021-02-05,3635,38717,2820,20380,815,18337,0,0,3207,21129,423,8788,3207,29917,California
Monterey,2021-02-06,1088,39805,377,20757,711,19048,0,0,750,21542,337,9125,750,30667,California
Monterey,2021-02-07,312,40117,268,21025,44,19092,0,0,95,21420,217,9342,95,30762,California
Monterey,2021-02-08,498,40615,285,21310,213,19305,0,0,415,21752,83,9425,415,31177,California
Monterey,2021-02-09,859,41474,678,21988,181,19486,0,0,549,21993,310,9735,551,31728,California
Monterey,2021-02-10,2004,43478,1038,23026,966,20452,0,0,1158,22305,846,10581,1158,32886,California
Monterey,2021-02-11,2439,45917,941,23967,1498,21950,0,0,1504,22879,932,11513,1506,34392,California
Monterey,2021-02-12,2544,48461,417,24384,2127,24077,0,0,1497,23331,1046,12559,1498,35890,California
Monterey,2021-02-13,1047,49508,43,24427,1004,25081,0,0,960,24204,87,12646,960,36850,California
Monterey,2021-02-14,585,50093,73,24500,512,25593,0,0,512,24643,73,12719,512,37362,California
Monterey,2021-02-15,1330,51423,130,24630,1200,26793,0,0,964,25241,366,13085,964,38326,California
Monterey,2021-02-16,1050,52473,240,24870,810,27603,0,0,829,25850,221,13306,830,39156,California
Monterey,2021-02-17,1834,54307,1101,25971,733,28336,0,0,1554,27127,278,13584,1555,40711,California
Monterey,2021-02-18,2097,56404,1084,27055,1013,29349,0,0,834,26708,1255,14839,836,41547,California
Monterey,2021-02-19,2854,59258,1525,28580,1329,30678,0,0,1321,26497,1533,16372,1322,42869,California
Monterey,2021-02-20,955,60213,595,29175,360,31038,0,0,910,27363,44,16416,910,43779,California
Monterey,2021-02-21,1191,61404,1163,30338,28,31066,0,0,1156,28485,34,16450,1156,44935,California
Monterey,2021-02-22,905,62309,796,31134,109,31175,0,0,603,28787,301,16751,603,45538,California
Monterey,2021-02-23,935,63244,613,31747,322,31497,0,0,296,28445,639,17390,297,45835,California
Monterey,2021-02-24,2354,65598,1216,32963,1138,32635,0,0,1765,29626,586,17976,1767,47602,California
Monterey,2021-02-25,4181,69779,2304,35267,1877,34512,0,0,1358,28162,2822,20798,1358,48960,California
Monterey,2021-02-26,4954,74733,2949,38216,2005,36517,0,0,2441,28097,2509,23307,2444,51404,California
Monterey,2021-02-27,970,75703,168,38384,802,37319,0,0,784,28699,182,23489,784,52188,California
Monterey,2021-02-28,1466,77169,76,38460,1390,38709,0,0,1012,29260,451,23940,1012,53200,California
Monterey,2021-03-01,1234,78403,135,38595,1099,39808,0,0,712,29452,520,24460,712,53912,California
Monterey,2021-03-02,2559,80962,1629,40224,930,40738,0,0,1810,30518,744,25204,1810,55722,California
Monterey,2021-03-03,2859,83821,1143,41367,1716,42454,0,0,1106,29873,1751,26955,1106,56828,California
Monterey,2021-03-04,4248,88069,1364,42731,2884,45338,0,0,2816,31264,1428,28383,2819,59647,California
Monterey,2021-03-05,2910,90979,1228,43959,1426,46764,256,256,2322,33257,587,28970,2580,62227,California
Monterey,2021-03-06,3372,94351,620,44579,2515,49279,237,493,2545,35213,826,29796,2782,65009,California
Monterey,2021-03-07,489,94840,108,44687,159,49438,222,715,225,35396,264,30060,447,65456,California
Monterey,2021-03-08,1387,96227,301,44988,786,50224,300,1015,978,36269,409,30469,1282,66738,California
Monterey,2021-03-09,1808,98035,678,45666,891,51115,239,1254,1369,37439,439,30908,1609,68347,California
Monterey,2021-03-10,2745,100780,851,46517,1479,52594,415,1669,1326,37766,1416,32324,1743,70090,California
Monterey,2021-03-11,3930,104710,1387,47904,2231,54825,312,1981,2297,38749,1628,33952,2611,72701,California
Monterey,2021-03-12,3675,108385,1794,49698,1798,56623,83,2064,2277,39712,1396,35348,2359,75060,California
Monterey,2021-03-13,2836,111221,866,50564,1745,58368,225,2289,1958,41021,878,36226,2187,77247,California
Monterey,2021-03-14,1614,112835,1185,51749,405,58773,24,2313,377,40191,1232,37458,402,77649,California
Monterey,2021-03-15,3813,116648,1224,52973,2310,61083,279,2592,2173,41004,1639,39097,2452,80101,California
Monterey,2021-03-16,3269,119917,554,53527,2419,63502,296,2888,1973,41978,1295,40392,2269,82370,California
Monterey,2021-03-17,4646,124563,2159,55686,2332,65834,155,3043,3287,44072,1353,41745,3447,85817,California
Monterey,2021-03-18,2200,126763,1114,56800,1007,66841,79,3122,1419,44831,779,42524,1538,87355,California
Monterey,2021-03-19,1745,128508,757,57557,956,67797,32,3154,1275,45671,467,42991,1307,88662,California
Butte,2020-12-16,3,3,3,3,0,0,0,0,3,3,0,0,3,3,California
Butte,2020-12-17,20,23,20,23,0,0,0,0,20,23,0,0,20,23,California
Butte,2020-12-18,50,73,50,73,0,0,0,0,50,73,0,0,50,73,California
Butte,2020-12-19,7,80,7,80,0,0,0,0,7,80,0,0,7,80,California
Butte,2020-12-20,10,90,10,90,0,0,0,0,10,90,0,0,10,90,California
Butte,2020-12-21,633,723,633,723,0,0,0,0,633,723,0,0,633,723,California
Butte,2020-12-22,618,1341,616,1339,2,2,0,0,618,1341,0,0,618,1341,California
Butte,2020-12-23,870,2211,854,2193,16,18,0,0,870,2211,0,0,870,2211,California
Butte,2020-12-24,160,2371,157,2350,3,21,0,0,160,2371,0,0,160,2371,California
Butte,2020-12-26,93,2464,91,2441,2,23,0,0,93,2464,0,0,93,2464,California
Butte,2020-12-27,35,2499,34,2475,1,24,0,0,35,2499,0,0,35,2499,California
Butte,2020-12-28,280,2779,274,2749,6,30,0,0,280,2779,0,0,280,2779,California
Butte,2020-12-29,203,2982,180,2929,23,53,0,0,203,2982,0,0,203,2982,California
Butte,2020-12-30,497,3479,289,3218,208,261,0,0,497,3479,0,0,497,3479,California
Butte,2020-12-31,210,3689,18,3236,192,453,0,0,210,3689,0,0,210,3689,California
Butte,2021-01-01,7,3696,1,3237,6,459,0,0,7,3696,0,0,7,3696,California
Butte,2021-01-02,37,3733,36,3273,1,460,0,0,37,3733,0,0,37,3733,California
Butte,2021-01-03,4,3737,1,3274,3,463,0,0,4,3737,0,0,4,3737,California
Butte,2021-01-04,206,3943,173,3447,33,496,0,0,206,3943,0,0,206,3943,California
Butte,2021-01-05,194,4137,151,3598,43,539,0,0,193,4135,1,1,193,4136,California
Butte,2021-01-06,622,4759,396,3994,226,765,0,0,618,4749,4,5,618,4754,California
Butte,2021-01-07,760,5519,369,4363,391,1156,0,0,741,5471,19,24,741,5495,California
Butte,2021-01-08,570,6089,529,4892,41,1197,0,0,524,5949,46,70,524,6019,California
Butte,2021-01-09,11,6100,7,4899,4,1201,0,0,6,5950,5,75,6,6025,California
Butte,2021-01-10,19,6119,5,4904,14,1215,0,0,14,5959,5,80,14,6039,California
Butte,2021-01-11,987,7106,951,5855,36,1251,0,0,358,5691,629,709,361,6400,California
Butte,2021-01-12,696,7802,652,6507,44,1295,0,0,273,5541,423,1132,273,6673,California
Butte,2021-01-13,1444,9246,955,7462,489,1784,0,0,609,5317,835,1967,611,7284,California
Butte,2021-01-14,1637,10883,898,8360,739,2523,0,0,1440,6561,196,2163,1440,8724,California
Butte,2021-01-15,1168,12051,926,9286,242,2765,0,0,1058,7508,111,2274,1058,9782,California
Butte,2021-01-16,583,12634,300,9586,283,3048,0,0,538,8001,45,2319,538,10320,California
Butte,2021-01-17,239,12873,64,9650,175,3223,0,0,202,8166,37,2356,202,10522,California
Butte,2021-01-18,342,13215,301,9951,41,3264,0,0,274,8373,67,2423,274,10796,California
Butte,2021-01-19,489,13704,426,10377,63,3327,0,0,216,8319,273,2696,219,11015,California
Butte,2021-01-20,1343,15047,663,11040,680,4007,0,0,1043,9062,300,2996,1043,12058,California
Butte,2021-01-21,1473,16520,867,11907,606,4613,0,0,1367,10324,105,3101,1367,13425,California
Butte,2021-01-22,987,17507,332,12239,655,5268,0,0,934,11205,53,3154,934,14359,California
Butte,2021-01-23,123,17630,82,12321,41,5309,0,0,98,11278,25,3179,98,14457,California
Butte,2021-01-24,9,17639,6,12327,3,5312,0,0,9,11287,0,3179,9,14466,California
Butte,2021-01-25,648,18287,334,12661,314,5626,0,0,486,11611,162,3341,486,14952,California
Butte,2021-01-26,1453,19740,374,13035,1079,6705,0,0,1317,12792,136,3477,1317,16269,California
Butte,2021-01-27,2070,21810,704,13739,1366,8071,0,0,1357,13436,713,4190,1357,17626,California
Butte,2021-01-28,2249,24059,255,13994,1994,10065,0,0,1941,15070,307,4497,1941,19567,California
Butte,2021-01-29,1668,25727,484,14478,1184,11249,0,0,1289,15981,378,4875,1289,20856,California
Butte,2021-01-30,32,25759,10,14488,22,11271,0,0,29,16007,3,4878,29,20885,California
Butte,2021-01-31,15,25774,13,14501,2,11273,0,0,14,16020,1,4879,14,20899,California
Butte,2021-02-01,1733,27507,403,14904,1330,12603,0,0,1349,16987,382,5261,1349,22248,California
Butte,2021-02-02,1928,29435,361,15265,1567,14170,0,0,1625,18309,303,5564,1625,23873,California
Butte,2021-02-03,2730,32165,772,16037,1958,16128,0,0,1840,19260,889,6453,1840,25713,California
Butte,2021-02-04,2947,35112,320,16357,2627,18755,0,0,2392,21099,553,7006,2392,28105,California
Butte,2021-02-05,1166,36278,659,17016,507,19262,0,0,541,21015,625,7631,541,28646,California
Butte,2021-02-06,142,36420,102,17118,40,19302,0,0,60,20993,82,7713,60,28706,California
Butte,2021-02-07,38,36458,34,17152,4,19306,0,0,15,20985,23,7736,15,28721,California
Butte,2021-02-08,688,37146,538,17690,150,19456,0,0,239,20775,449,8185,239,28960,California
Butte,2021-02-09,949,38095,455,18145,494,19950,0,0,722,21270,227,8412,722,29682,California
Butte,2021-02-10,1695,39790,1185,19330,510,20460,0,0,694,20963,1001,9413,694,30376,California
Butte,2021-02-11,2190,41980,1343,20673,847,21307,0,0,1000,20774,1190,10603,1001,31377,California
Butte,2021-02-12,858,42838,297,20970,561,21868,0,0,313,20543,544,11147,313,31690,California
Butte,2021-02-13,246,43084,45,21015,201,22069,0,0,144,20585,102,11249,144,31834,California
Butte,2021-02-14,158,43242,11,21026,147,22216,0,0,153,20733,5,11254,153,31987,California
Butte,2021-02-15,256,43498,47,21073,209,22425,0,0,194,20865,62,11316,194,32181,California
Butte,2021-02-16,726,44224,430,21503,296,22721,0,0,270,20679,456,11772,270,32451,California
Butte,2021-02-17,1500,45724,840,22343,660,23381,0,0,829,20838,670,12442,829,33280,California
Butte,2021-02-18,1540,47264,752,23095,788,24169,0,0,744,20786,796,13238,744,34024,California
Butte,2021-02-19,1163,48427,387,23482,776,24945,0,0,404,20436,754,13992,404,34428,California
Butte,2021-02-20,458,48885,29,23511,429,25374,0,0,106,20190,352,14344,106,34534,California
Butte,2021-02-21,14,48899,11,23522,3,25377,0,0,10,20196,4,14348,10,34544,California
Butte,2021-02-22,1432,50331,292,23814,1140,26517,0,0,381,19527,1050,15398,381,34925,California
Butte,2021-02-23,1590,51921,297,24111,1293,27810,0,0,439,18819,1148,16546,440,35365,California
Butte,2021-02-24,2093,54014,584,24695,1509,29319,0,0,726,18184,1361,17907,726,36091,California
Butte,2021-02-25,1999,56013,576,25271,1423,30742,0,0,654,17497,1342,19249,655,36746,California
Butte,2021-02-26,855,56868,296,25567,559,31301,0,0,382,17408,471,19720,382,37128,California
Butte,2021-02-27,228,57096,42,25609,186,31487,0,0,181,17545,44,19764,181,37309,California
Butte,2021-02-28,114,57210,17,25626,97,31584,0,0,104,17640,9,19773,104,37413,California
Butte,2021-03-01,1411,58621,174,25800,1237,32821,0,0,309,16849,1101,20874,310,37723,California
Butte,2021-03-02,1492,60113,166,25966,1326,34147,0,0,253,15865,1237,22111,253,37976,California
Butte,2021-03-03,2321,62434,809,26775,1512,35659,0,0,427,14400,1893,24004,428,38404,California
Butte,2021-03-04,2620,65054,625,27400,1995,37654,0,0,573,12927,2046,26050,573,38977,California
Butte,2021-03-05,1259,66313,598,27998,660,38314,1,1,692,13054,566,26616,693,39670,California
Butte,2021-03-06,197,66510,31,28029,146,38460,20,21,145,13167,52,26668,165,39835,California
Butte,2021-03-07,60,66570,9,28038,34,38494,17,38,31,13186,29,26697,48,39883,California
Butte,2021-03-08,1127,67697,124,28162,939,39433,64,102,1016,14157,110,26807,1081,40964,California
Butte,2021-03-09,1674,69371,278,28440,1309,40742,87,189,1319,15209,354,27161,1406,42370,California
Butte,2021-03-10,2168,71539,923,29363,1197,41939,48,237,1514,16120,652,27813,1563,43933,California
Butte,2021-03-11,2650,74189,1233,30596,1311,43250,106,343,1862,17311,778,28591,1969,45902,California
Butte,2021-03-12,946,75135,285,30881,395,43645,266,609,329,17292,614,29205,595,46497,California
Butte,2021-03-13,188,75323,53,30934,90,43735,45,654,59,17267,129,29334,104,46601,California
Butte,2021-03-14,116,75439,13,30947,62,43797,41,695,20,17232,96,29430,61,46662,California
Butte,2021-03-15,1668,77107,348,31295,1050,44847,270,965,1107,18051,558,29988,1377,48039,California
Butte,2021-03-16,1601,78708,410,31705,1121,45968,70,1035,1074,18671,525,30513,1145,49184,California
Butte,2021-03-17,1638,80346,1325,33030,256,46224,57,1092,887,18869,746,31259,944,50128,California
Butte,2021-03-18,1034,81380,867,33897,113,46337,54,1146,593,19077,439,31698,647,50775,California
Butte,2021-03-19,309,81689,161,34058,128,46465,20,1166,161,19110,148,31846,181,50956,California
Ventura,2020-12-15,5,5,5,5,0,0,0,0,5,5,0,0,5,5,California
Ventura,2020-12-16,70,75,70,75,0,0,0,0,70,75,0,0,70,75,California
Ventura,2020-12-17,249,324,249,324,0,0,0,0,249,324,0,0,249,324,California
Ventura,2020-12-18,1407,1731,1407,1731,0,0,0,0,1407,1731,0,0,1407,1731,California
Ventura,2020-12-19,912,2643,912,2643,0,0,0,0,912,2643,0,0,912,2643,California
Ventura,2020-12-20,430,3073,430,3073,0,0,0,0,430,3073,0,0,430,3073,California
Ventura,2020-12-21,1465,4538,1465,4538,0,0,0,0,1465,4538,0,0,1465,4538,California
Ventura,2020-12-22,1102,5640,1098,5636,4,4,0,0,1102,5640,0,0,1102,5640,California
Ventura,2020-12-23,1024,6664,978,6614,46,50,0,0,1024,6664,0,0,1024,6664,California
Ventura,2020-12-24,476,7140,379,6993,97,147,0,0,476,7140,0,0,476,7140,California
Ventura,2020-12-25,11,7151,7,7000,4,151,0,0,11,7151,0,0,11,7151,California
Ventura,2020-12-26,106,7257,86,7086,20,171,0,0,106,7257,0,0,106,7257,California
Ventura,2020-12-27,58,7315,27,7113,31,202,0,0,58,7315,0,0,58,7315,California
Ventura,2020-12-28,1064,8379,926,8039,138,340,0,0,1064,8379,0,0,1064,8379,California
Ventura,2020-12-29,1165,9544,762,8801,403,743,0,0,1165,9544,0,0,1165,9544,California
Ventura,2020-12-30,1984,11528,1517,10318,467,1210,0,0,1984,11528,0,0,1984,11528,California
Ventura,2020-12-31,472,12000,161,10479,311,1521,0,0,472,12000,0,0,472,12000,California
Ventura,2021-01-01,11,12011,1,10480,10,1531,0,0,11,12011,0,0,11,12011,California
Ventura,2021-01-02,169,12180,77,10557,92,1623,0,0,169,12180,0,0,169,12180,California
Ventura,2021-01-03,15,12195,8,10565,7,1630,0,0,15,12195,0,0,15,12195,California
Ventura,2021-01-04,1075,13270,547,11112,528,2158,0,0,1074,13269,0,0,1074,13269,California
Ventura,2021-01-05,1369,14639,776,11888,593,2751,0,0,1329,14558,40,40,1329,14598,California
Ventura,2021-01-06,2046,16685,1174,13062,872,3623,0,0,1617,15757,420,460,1619,16217,California
Ventura,2021-01-07,2063,18748,1325,14387,738,4361,0,0,1181,16059,880,1340,1182,17399,California
Ventura,2021-01-08,2193,20941,1474,15861,719,5080,0,0,901,15671,1290,2630,902,18301,California
Ventura,2021-01-09,722,21663,501,16362,221,5301,0,0,318,15585,404,3034,318,18619,California
Ventura,2021-01-10,336,21999,324,16686,12,5313,0,0,122,15493,214,3248,122,18741,California
Ventura,2021-01-11,2444,24443,1485,18171,959,6272,0,0,1494,16039,950,4198,1496,20237,California
Ventura,2021-01-12,3025,27468,1600,19771,1425,7697,0,0,2003,17020,1022,5220,2003,22240,California
Ventura,2021-01-13,2924,30392,1420,21191,1504,9201,0,0,2042,18183,880,6100,2043,24283,California
Ventura,2021-01-14,2722,33114,1055,22246,1667,10868,0,0,2278,20019,443,6543,2279,26562,California
Ventura,2021-01-15,2861,35975,955,23201,1906,12774,0,0,2651,22462,210,6753,2653,29215,California
Ventura,2021-01-16,485,36460,189,23390,296,13070,0,0,403,22783,82,6835,403,29618,California
Ventura,2021-01-17,262,36722,137,23527,125,13195,0,0,256,23033,6,6841,256,29874,California
Ventura,2021-01-18,2203,38925,1660,25187,543,13738,0,0,1655,24141,548,7389,1656,31530,California
Ventura,2021-01-19,3007,41932,2101,27288,906,14644,0,0,2118,25374,889,8278,2122,33652,California
Ventura,2021-01-20,4038,45970,3094,30382,944,15588,0,0,3004,27348,1031,9309,3005,36657,California
Ventura,2021-01-21,3826,49796,2664,33046,1162,16750,0,0,3160,29845,663,9972,3160,39817,California
Ventura,2021-01-22,3588,53384,2465,35511,1123,17873,0,0,3427,33112,161,10133,3428,43245,California
Ventura,2021-01-23,1181,54565,646,36157,535,18408,0,0,1081,34096,99,10232,1083,44328,California
Ventura,2021-01-24,448,55013,134,36291,314,18722,0,0,435,34518,13,10245,435,44763,California
Ventura,2021-01-25,3115,58128,2008,38299,1107,19829,0,0,2572,36549,542,10787,2573,47336,California
Ventura,2021-01-26,3667,61795,2169,40468,1498,21327,0,0,2677,38237,989,11776,2677,50013,California
Ventura,2021-01-27,3428,65223,1538,42006,1890,23217,0,0,2691,40194,734,12510,2691,52704,California
Ventura,2021-01-28,3829,69052,1969,43975,1860,25077,0,0,3226,42833,588,13098,3227,55931,California
Ventura,2021-01-29,4204,73256,2485,46460,1719,26796,0,0,3714,46067,480,13578,3714,59645,California
Ventura,2021-01-30,3014,76270,1945,48405,1069,27865,0,0,2850,48757,161,13739,2851,62496,California
Ventura,2021-01-31,827,77097,444,48849,383,28248,0,0,743,49416,84,13823,743,63239,California
Ventura,2021-02-01,3912,81009,2101,50950,1811,30059,0,0,3153,51813,757,14580,3154,66393,California
Ventura,2021-02-02,4372,85381,2354,53304,2018,32077,0,0,3354,54153,1015,15595,3355,69748,California
Ventura,2021-02-03,4448,89829,2083,55387,2365,34442,0,0,3443,56596,1000,16595,3443,73191,California
Ventura,2021-02-04,4729,94558,2257,57644,2472,36914,0,0,3495,58865,1226,17821,3495,76686,California
Ventura,2021-02-05,4802,99360,2301,59945,2501,39415,0,0,3319,60716,1470,19291,3321,80007,California
Ventura,2021-02-06,2816,102176,1504,61449,1312,40727,0,0,2420,62740,396,19687,2420,82427,California
Ventura,2021-02-07,711,102887,234,61683,477,41204,0,0,587,63203,124,19811,587,83014,California
Ventura,2021-02-08,3463,106350,1609,63292,1854,43058,0,0,2407,64558,1052,20863,2407,85421,California
Ventura,2021-02-09,4693,111043,1966,65258,2727,45785,0,0,2463,64795,2229,23092,2466,87887,California
Ventura,2021-02-10,4587,115630,2205,67463,2382,48167,0,0,2363,64946,2214,25306,2365,90252,California
Ventura,2021-02-11,4592,120222,1836,69299,2756,50923,0,0,2405,65172,2181,27487,2407,92659,California
Ventura,2021-02-12,6232,126454,2620,71919,3612,54535,0,0,3181,65302,3051,30538,3181,95840,California
Ventura,2021-02-13,3252,129706,1811,73730,1441,55976,0,0,1814,65682,1434,31972,1814,97654,California
Ventura,2021-02-14,1212,130918,122,73852,1090,57066,0,0,999,66469,213,32185,1000,98654,California
Ventura,2021-02-15,3950,134868,1776,75628,2174,59240,0,0,2089,66699,1859,34044,2089,100743,California
Ventura,2021-02-16,5401,140269,2654,78282,2747,61987,0,0,2967,67235,2432,36476,2968,103711,California
Ventura,2021-02-17,5133,145402,1890,80172,3243,65230,0,0,3202,68513,1924,38400,3202,106913,California
Ventura,2021-02-18,5569,150971,1734,81906,3835,69065,0,0,3517,69986,2044,40444,3517,110430,California
Ventura,2021-02-19,6325,157296,3695,85601,2630,71695,0,0,2952,69579,3367,43811,2960,113390,California
Ventura,2021-02-20,4638,161934,2992,88593,1646,73341,0,0,2584,70113,2051,45862,2585,115975,California
Ventura,2021-02-21,944,162878,663,89256,281,73622,0,0,407,69986,534,46396,407,116382,California
Ventura,2021-02-22,5284,168162,2350,91606,2934,76556,0,0,3409,71531,1866,48262,3411,119793,California
Ventura,2021-02-23,5817,173979,2931,94537,2886,79442,0,0,3389,72517,2406,50668,3392,123185,California
Ventura,2021-02-24,4760,178739,1197,95734,3563,83005,0,0,3019,73808,1728,52396,3019,126204,California
Ventura,2021-02-25,7268,186007,2542,98276,4726,87731,0,0,4459,75474,2797,55193,4463,130667,California
Ventura,2021-02-26,8953,194960,2653,100929,6300,94031,0,0,5922,78388,3011,58204,5925,136592,California
Ventura,2021-02-27,9837,204797,5207,106136,4630,98661,0,0,7282,83136,2539,60743,7287,143879,California
Ventura,2021-02-28,2474,207271,1607,107743,866,99527,1,1,2029,84725,441,61184,2030,145909,California
Ventura,2021-03-01,6735,214006,2721,110464,4014,103541,0,1,4475,86960,2252,63436,4487,150396,California
Ventura,2021-03-02,7198,221204,3841,114305,3357,106898,0,1,5046,89864,2146,65582,5050,155446,California
Ventura,2021-03-03,8050,229254,3746,118051,4304,111202,0,1,5727,93284,2312,67894,5732,161178,California
Ventura,2021-03-04,7794,237048,3799,121850,3995,115197,0,1,5344,96192,2438,70332,5346,166524,California
Ventura,2021-03-05,9072,246120,4653,126503,4408,119605,11,12,6499,100148,2561,72893,6517,173041,California
Ventura,2021-03-06,5140,251260,2983,129486,2005,121610,152,164,3725,102614,1414,74307,3880,176921,California
Ventura,2021-03-07,1567,252827,600,130086,866,122476,101,265,1160,103469,406,74713,1261,178182,California
Ventura,2021-03-08,6006,258833,3259,133345,2637,125113,110,375,4208,105992,1796,76509,4319,182501,California
Ventura,2021-03-09,6264,265097,2710,136055,3390,128503,164,539,3523,106949,2732,79241,3689,186190,California
Ventura,2021-03-10,6354,271451,2895,138950,3275,131778,184,723,4199,109183,2150,81391,4384,190574,California
Ventura,2021-03-11,5901,277352,2783,141733,2955,134733,163,886,3288,110036,2607,83998,3460,194034,California
Ventura,2021-03-12,7178,284530,2850,144583,3604,138337,724,1610,3563,110718,3611,87609,4293,198327,California
Ventura,2021-03-13,5710,290240,2199,146782,2810,141147,701,2311,3354,112422,2353,89962,4057,202384,California
Ventura,2021-03-14,1632,291872,364,147146,849,141996,419,2730,563,112336,1068,91030,982,203366,California
Ventura,2021-03-15,6421,298293,1880,149026,3383,145379,1158,3888,2840,112766,3570,94600,4000,207366,California
Ventura,2021-03-16,7596,305889,2371,151397,4164,149543,1061,4949,3850,113939,3737,98337,4910,212276,California
Ventura,2021-03-17,5381,311270,2038,153435,3176,152719,167,5116,3328,115393,2041,100378,3495,215771,California
Ventura,2021-03-18,3343,314613,1657,155092,1587,154306,99,5215,2336,116825,1003,101381,2435,218206,California
Ventura,2021-03-19,2634,317247,1326,156418,1252,155558,56,5271,1466,117183,1162,102543,1520,219726,California
Riverside,2020-12-15,4,4,4,4,0,0,0,0,4,4,0,0,4,4,California
Riverside,2020-12-16,63,67,63,67,0,0,0,0,63,67,0,0,63,67,California
Riverside,2020-12-17,803,870,803,870,0,0,0,0,803,870,0,0,803,870,California
Riverside,2020-12-18,1721,2591,1720,2590,1,1,0,0,1721,2591,0,0,1721,2591,California
Riverside,2020-12-19,1020,3611,1018,3608,2,3,0,0,1018,3608,1,1,1018,3609,California
Riverside,2020-12-20,1077,4688,1077,4685,0,3,0,0,1077,4685,0,1,1077,4686,California
Riverside,2020-12-21,2268,6956,2267,6952,1,4,0,0,2268,6953,0,1,2268,6954,California
Riverside,2020-12-22,2243,9199,2204,9156,39,43,0,0,2242,9195,0,1,2242,9196,California
Riverside,2020-12-23,2116,11315,1782,10938,334,377,0,0,2117,11312,0,1,2117,11313,California
Riverside,2020-12-24,819,12134,620,11558,199,576,0,0,819,12131,0,1,819,12132,California
Riverside,2020-12-25,28,12162,5,11563,23,599,0,0,28,12159,0,1,28,12160,California
Riverside,2020-12-26,401,12563,257,11820,144,743,0,0,401,12560,0,1,401,12561,California
Riverside,2020-12-27,362,12925,245,12065,117,860,0,0,362,12922,0,1,362,12923,California
Riverside,2020-12-28,1617,14542,1121,13186,496,1356,0,0,1617,14539,0,1,1617,14540,California
Riverside,2020-12-29,1733,16275,969,14155,764,2120,0,0,1733,16272,0,1,1733,16273,California
Riverside,2020-12-30,2559,18834,1675,15830,884,3004,0,0,2558,18830,0,1,2558,18831,California
Riverside,2020-12-31,1014,19848,394,16224,620,3624,0,0,1016,19846,0,1,1016,19847,California
Riverside,2021-01-01,96,19944,36,16260,60,3684,0,0,96,19942,0,1,96,19943,California
Riverside,2021-01-02,822,20766,688,16948,134,3818,0,0,822,20764,0,1,822,20765,California
Riverside,2021-01-03,342,21108,296,17244,46,3864,0,0,341,21105,0,1,341,21106,California
Riverside,2021-01-04,1250,22358,793,18037,457,4321,0,0,1250,22355,0,1,1250,22356,California
Riverside,2021-01-05,1977,24335,1361,19398,616,4937,0,0,1880,24144,91,92,1880,24236,California
Riverside,2021-01-06,2454,26789,1093,20491,1361,6298,0,0,2150,25994,300,392,2150,26386,California
Riverside,2021-01-07,2740,29529,1801,22292,939,7237,0,0,1686,26634,1050,1442,1690,28076,California
Riverside,2021-01-08,4013,33542,2925,25217,1088,8325,0,0,2211,27049,1798,3240,2213,30289,California
Riverside,2021-01-09,2061,35603,835,26052,1226,9551,0,0,1716,28422,343,3583,1716,32005,California
Riverside,2021-01-10,1658,37261,732,26784,926,10477,0,0,1055,28874,603,4186,1055,33060,California
Riverside,2021-01-11,4480,41741,3084,29868,1396,11873,0,0,2758,29914,1720,5906,2760,35820,California
Riverside,2021-01-12,3374,45115,2713,32581,661,12534,0,0,1695,29935,1674,7580,1695,37515,California
Riverside,2021-01-13,4360,49475,2862,35443,1498,14032,0,0,2764,31106,1593,9173,2764,40279,California
Riverside,2021-01-14,5417,54892,1852,37295,3565,17597,0,0,4836,35361,581,9754,4836,45115,California
Riverside,2021-01-15,6121,61013,2082,39377,4039,21636,0,0,5835,40912,285,10039,5836,50951,California
Riverside,2021-01-16,3597,64610,1010,40387,2587,24223,0,0,3352,44020,245,10284,3353,54304,California
Riverside,2021-01-17,3597,68207,579,40966,3018,27241,0,0,3402,47228,194,10478,3402,57706,California
Riverside,2021-01-18,3685,71892,1993,42959,1692,28933,0,0,2683,48909,1002,11480,2683,60389,California
Riverside,2021-01-19,7363,79255,2624,45583,4739,33672,0,0,6249,54048,1114,12594,6253,66642,California
Riverside,2021-01-20,7949,87204,2858,48441,5091,38763,0,0,6475,59060,1465,14059,6477,73119,California
Riverside,2021-01-21,8112,95316,3360,51801,4752,43515,0,0,7500,65947,613,14672,7500,80619,California
Riverside,2021-01-22,8591,103907,2963,54764,5628,49143,0,0,8162,73682,428,15100,8163,88782,California
Riverside,2021-01-23,5949,109856,2388,57152,3561,52704,0,0,5224,78182,725,15825,5225,94007,California
Riverside,2021-01-24,3069,112925,1437,58589,1632,54336,0,0,2858,80832,209,16034,2859,96866,California
Riverside,2021-01-25,7829,120754,4520,63109,3309,57645,0,0,6713,86436,1114,17148,6718,103584,California
Riverside,2021-01-26,9048,129802,5717,68826,3331,60976,0,0,7543,92480,1504,18652,7548,111132,California
Riverside,2021-01-27,10485,140287,6166,74992,4319,65295,0,0,8992,99984,1490,20142,8994,120126,California
Riverside,2021-01-28,11318,151605,6646,81638,4672,69967,0,0,10181,109039,1130,21272,10185,130311,California
Riverside,2021-01-29,11803,163408,7198,88836,4605,74572,0,0,10440,118147,1336,22608,10444,140755,California
Riverside,2021-01-30,9025,172433,4573,93409,4452,79024,0,0,8584,126294,439,23047,8586,149341,California
Riverside,2021-01-31,5179,177612,4254,97663,925,79949,0,0,5055,131229,123,23170,5058,154399,California
Riverside,2021-02-01,10784,188396,6635,104298,4149,84098,0,0,9026,138506,1753,24923,9030,163429,California
Riverside,2021-02-02,9361,197757,4761,109059,4600,88698,0,0,7896,144947,1458,26381,7899,171328,California
Riverside,2021-02-03,12045,209802,4979,114038,7066,95764,0,0,9844,152600,2191,28572,9844,181172,California
Riverside,2021-02-04,13573,223375,6053,120091,7520,103284,0,0,11492,162030,2074,30646,11504,192676,California
Riverside,2021-02-05,14291,237666,5383,125474,8908,112192,0,0,11273,170298,3011,33657,11279,203955,California
Riverside,2021-02-06,7293,244959,4259,129733,3034,115226,0,0,5678,174367,1609,35266,5678,209633,California
Riverside,2021-02-07,2215,247174,806,130539,1409,116635,0,0,1908,175968,307,35573,1908,211541,California
Riverside,2021-02-08,12255,259429,5489,136028,6766,123401,0,0,10017,183766,2223,37796,10021,221562,California
Riverside,2021-02-09,9569,268998,4481,140509,5088,128489,0,0,7687,189583,1875,39671,7692,229254,California
Riverside,2021-02-10,11693,280691,6845,147354,4848,133337,0,0,8761,195424,2923,42594,8764,238018,California
Riverside,2021-02-11,16270,296961,8898,156252,7372,140709,0,0,12005,203191,4246,46840,12013,250031,California
Riverside,2021-02-12,17256,314217,10564,166816,6692,147401,0,0,12411,210809,4806,51646,12424,262455,California
Riverside,2021-02-13,6293,320510,2105,168921,4188,151589,0,0,3091,210717,3186,54832,3094,265549,California
Riverside,2021-02-14,4947,325457,1155,170076,3792,155381,0,0,2196,210166,2747,57579,2196,267745,California
Riverside,2021-02-15,9776,335233,4984,175060,4792,160173,0,0,5388,211179,4383,61962,5396,273141,California
Riverside,2021-02-16,15827,351060,9992,185052,5835,166008,0,0,9125,213625,6694,68656,9140,282281,California
Riverside,2021-02-17,14029,365089,7842,192894,6187,172195,0,0,7040,213693,6978,75634,7046,289327,California
Riverside,2021-02-18,14040,379129,8068,200962,5972,178167,0,0,7427,214541,6596,82230,7444,296771,California
Riverside,2021-02-19,14623,393752,7907,208869,6716,184883,0,0,7006,213961,7601,89831,7021,303792,California
Riverside,2021-02-20,7354,401106,3855,212724,3499,188382,0,0,1719,210060,5623,95454,1722,305514,California
Riverside,2021-02-21,3186,404292,2716,215440,470,188852,0,0,1007,208898,2170,97624,1008,306522,California
Riverside,2021-02-22,12025,416317,7488,222928,4537,193389,0,0,5001,206891,7014,104638,5007,311529,California
Riverside,2021-02-23,10748,427065,7339,230267,3409,196798,0,0,5294,206756,5435,110073,5300,316829,California
Riverside,2021-02-24,14031,441096,7622,237889,6409,203207,0,0,6025,204842,7968,118041,6054,322883,California
Riverside,2021-02-25,16050,457146,6971,244860,9079,212286,0,0,7449,203756,8581,126622,7495,330378,California
Riverside,2021-02-26,17062,474208,6226,251086,10836,223122,0,0,8516,203822,8498,135120,8564,338942,California
Riverside,2021-02-27,10956,485164,4775,255861,6181,229303,0,0,5506,203942,5413,140533,5533,344475,California
Riverside,2021-02-28,4409,489573,2905,258766,1504,230807,0,0,2252,204056,2150,142683,2264,346739,California
Riverside,2021-03-01,13235,502808,5678,264444,7556,238363,1,1,7848,206568,5364,148047,7876,354615,California
Riverside,2021-03-02,13599,516407,6659,271103,6939,245302,1,2,8215,209444,5358,153405,8234,362849,California
Riverside,2021-03-03,15656,532063,7718,278821,7938,253240,0,2,6567,206994,9047,162452,6597,369446,California
Riverside,2021-03-04,14573,546636,5512,284333,9057,262297,4,6,7239,206977,7300,169752,7283,376729,California
Riverside,2021-03-05,14499,561135,6154,290487,8312,270609,33,39,7542,207654,6925,176677,7602,384331,California
Riverside,2021-03-06,7880,569015,4075,294562,3372,273981,433,472,4093,208414,3776,180453,4536,388867,California
Riverside,2021-03-07,3853,572868,2604,297166,882,274863,367,839,1818,208580,2029,182482,2195,391062,California
Riverside,2021-03-08,8146,581014,3257,300423,4579,279442,310,1149,3648,208071,4488,186970,3979,395041,California
Riverside,2021-03-09,12239,593253,5753,306176,6050,285492,436,1585,5039,206370,7187,194157,5486,400527,California
Riverside,2021-03-10,12375,605628,6345,312521,5315,290807,715,2300,4969,204692,7378,201535,5700,406227,California
Riverside,2021-03-11,15563,621191,7778,320299,6624,297431,1161,3461,6332,203052,9203,210738,7563,413790,California
Riverside,2021-03-12,16876,638067,6449,326748,6642,304073,3785,7246,5666,201355,11189,221927,9492,423282,California
Riverside,2021-03-13,6274,644341,1845,328593,3708,307781,721,7967,3538,202911,2723,224650,4279,427561,California
Riverside,2021-03-14,3497,647838,1213,329806,1182,308963,1102,9069,1602,203729,1891,226541,2709,430270,California
Riverside,2021-03-15,17529,665367,7478,337284,8534,317497,1517,10586,8501,204760,9003,235544,10034,440304,California
Riverside,2021-03-16,19791,685158,9446,346730,9581,327078,764,11350,10713,207210,9027,244571,11477,451781,California
Riverside,2021-03-17,16903,702061,8832,355562,7279,334357,792,12142,10455,212072,6431,251002,11293,463074,California
Riverside,2021-03-18,10115,712176,5260,360822,4351,338708,504,12646,5692,213885,4402,255404,6215,469289,California
Riverside,2021-03-19,9990,722166,5108,365930,4514,343222,368,13014,6571,217464,3402,258806,6981,476270,California
Inyo,2020-12-18,1,1,1,1,0,0,0,0,1,1,0,0,1,1,California
Inyo,2020-12-19,85,86,85,86,0,0,0,0,85,86,0,0,85,86,California
Inyo,2020-12-20,58,144,58,144,0,0,0,0,58,144,0,0,58,144,California
Inyo,2020-12-21,88,232,85,229,3,3,0,0,88,232,0,0,88,232,California
Inyo,2020-12-22,104,336,104,333,0,3,0,0,104,336,0,0,104,336,California
Inyo,2020-12-23,71,407,68,401,3,6,0,0,71,407,0,0,71,407,California
Inyo,2020-12-24,17,424,17,418,0,6,0,0,17,424,0,0,17,424,California
Inyo,2020-12-25,1,425,0,418,1,7,0,0,1,425,0,0,1,425,California
Inyo,2020-12-26,74,499,74,492,0,7,0,0,74,499,0,0,74,499,California
Inyo,2020-12-28,48,547,36,528,12,19,0,0,48,547,0,0,48,547,California
Inyo,2020-12-29,20,567,20,548,0,19,0,0,20,567,0,0,20,567,California
Inyo,2020-12-30,56,623,54,602,2,21,0,0,56,623,0,0,56,623,California
Inyo,2020-12-31,29,652,0,602,29,50,0,0,29,652,0,0,29,652,California
Inyo,2021-01-01,1,653,0,602,1,51,0,0,1,653,0,0,1,653,California
Inyo,2021-01-03,1,654,0,602,1,52,0,0,1,654,0,0,1,654,California
Inyo,2021-01-04,1,655,1,603,0,52,0,0,1,655,0,0,1,655,California
Inyo,2021-01-05,34,689,0,603,34,86,0,0,34,689,0,0,34,689,California
Inyo,2021-01-06,68,757,0,603,68,154,0,0,68,757,0,0,68,757,California
Inyo,2021-01-07,31,788,1,604,30,184,0,0,31,788,0,0,31,788,California
Inyo,2021-01-08,9,797,8,612,1,185,0,0,4,787,5,5,4,792,California
Inyo,2021-01-09,87,884,86,698,1,186,0,0,1,702,86,91,1,793,California
Inyo,2021-01-10,52,936,52,750,0,186,0,0,0,650,52,143,0,793,California
Inyo,2021-01-11,97,1033,82,832,15,201,0,0,16,585,81,224,16,809,California
Inyo,2021-01-12,139,1172,117,949,22,223,0,0,29,504,110,334,29,838,California
Inyo,2021-01-13,87,1259,69,1018,18,241,0,0,21,459,66,400,21,859,California
Inyo,2021-01-14,59,1318,13,1031,46,287,0,0,49,498,10,410,49,908,California
Inyo,2021-01-15,162,1480,28,1059,134,421,0,0,162,660,0,410,162,1070,California
Inyo,2021-01-16,74,1554,73,1132,1,422,0,0,1,588,73,483,1,1071,California
Inyo,2021-01-18,58,1612,36,1168,22,444,0,0,19,568,39,522,19,1090,California
Inyo,2021-01-19,116,1728,73,1241,43,487,0,0,100,652,16,538,100,1190,California
Inyo,2021-01-20,141,1869,66,1307,75,562,0,0,88,687,53,591,88,1278,California
Inyo,2021-01-21,120,1989,57,1364,63,625,0,0,119,805,1,592,119,1397,California
Inyo,2021-01-22,62,2051,0,1364,62,687,0,0,61,865,1,593,61,1458,California
Inyo,2021-01-23,53,2104,53,1417,0,687,0,0,53,918,0,593,53,1511,California
Inyo,2021-01-25,49,2153,6,1423,43,730,0,0,37,943,12,605,37,1548,California
Inyo,2021-01-26,133,2286,51,1474,82,812,0,0,127,1064,6,611,127,1675,California
Inyo,2021-01-27,23,2309,2,1476,21,833,0,0,22,1085,1,612,22,1697,California
Inyo,2021-01-28,93,2402,2,1478,91,924,0,0,64,1120,29,641,64,1761,California
Inyo,2021-01-29,24,2426,3,1481,21,945,0,0,22,1140,2,643,22,1783,California
Inyo,2021-01-30,11,2437,1,1482,10,955,0,0,11,1151,0,643,11,1794,California
Inyo,2021-01-31,32,2469,4,1486,28,983,0,0,4,1127,28,671,4,1798,California
Inyo,2021-02-01,12,2481,9,1495,3,986,0,0,2,1119,10,681,2,1800,California
Inyo,2021-02-02,129,2610,14,1509,115,1101,0,0,103,1196,26,707,103,1903,California
Inyo,2021-02-03,116,2726,1,1510,115,1216,0,0,74,1228,42,749,74,1977,California
Inyo,2021-02-04,148,2874,31,1541,117,1333,0,0,89,1258,59,808,89,2066,California
Inyo,2021-02-05,118,2992,62,1603,56,1389,0,0,116,1372,2,810,116,2182,California
Inyo,2021-02-06,3,2995,1,1604,2,1391,0,0,2,1373,1,811,2,2184,California
Inyo,2021-02-07,3,2998,1,1605,2,1393,0,0,3,1376,0,811,3,2187,California
Inyo,2021-02-08,116,3114,7,1612,109,1502,0,0,96,1452,20,831,96,2283,California
Inyo,2021-02-09,193,3307,51,1663,142,1644,0,0,122,1503,71,902,122,2405,California
Inyo,2021-02-10,147,3454,16,1679,131,1775,0,0,115,1586,32,934,115,2520,California
Inyo,2021-02-11,214,3668,53,1732,161,1936,0,0,123,1618,91,1025,123,2643,California
Inyo,2021-02-12,302,3970,57,1789,245,2181,0,0,171,1658,131,1156,171,2814,California
Inyo,2021-02-13,60,4030,56,1845,4,2185,0,0,7,1612,53,1209,7,2821,California
Inyo,2021-02-14,1,4031,0,1845,1,2186,0,0,1,1613,0,1209,1,2822,California
Inyo,2021-02-15,29,4060,9,1854,20,2206,0,0,5,1594,24,1233,5,2827,California
Inyo,2021-02-16,180,4240,50,1904,130,2336,0,0,94,1602,86,1319,94,2921,California
Inyo,2021-02-17,36,4276,4,1908,32,2368,0,0,6,1578,30,1349,6,2927,California
Inyo,2021-02-18,116,4392,5,1913,111,2479,0,0,73,1608,43,1392,73,3000,California
Inyo,2021-02-19,50,4442,4,1917,46,2525,0,0,7,1572,43,1435,7,3007,California
Inyo,2021-02-20,501,4943,498,2415,3,2528,0,0,500,2071,1,1436,500,3507,California
Inyo,2021-02-21,267,5210,267,2682,0,2528,0,0,267,2338,0,1436,267,3774,California
Inyo,2021-02-22,60,5270,18,2700,42,2570,0,0,26,2330,34,1470,26,3800,California
Inyo,2021-02-23,193,5463,19,2719,174,2744,0,0,90,2318,102,1572,90,3890,California
Inyo,2021-02-24,117,5580,2,2721,115,2859,0,0,58,2317,59,1631,58,3948,California
Inyo,2021-02-25,125,5705,3,2724,122,2981,0,0,57,2306,68,1699,57,4005,California
Inyo,2021-02-26,103,5808,61,2785,42,3023,0,0,19,2241,84,1783,19,4024,California
Inyo,2021-02-27,13,5821,2,2787,11,3034,0,0,2,2232,11,1794,2,4026,California
Inyo,2021-02-28,2,5823,1,2788,1,3035,0,0,1,2232,1,1795,1,4027,California
Inyo,2021-03-01,23,5846,3,2791,20,3055,0,0,20,2249,3,1798,20,4047,California
Inyo,2021-03-02,176,6022,0,2791,176,3231,0,0,96,2265,80,1878,96,4143,California
Inyo,2021-03-03,82,6104,3,2794,79,3310,0,0,39,2261,43,1921,39,4182,California
Inyo,2021-03-04,120,6224,4,2798,116,3426,0,0,40,2221,80,2001,40,4222,California
Inyo,2021-03-05,149,6373,63,2861,86,3512,0,0,43,2159,105,2106,43,4265,California
Inyo,2021-03-06,29,6402,2,2863,27,3539,0,0,27,2184,2,2108,27,4292,California
Inyo,2021-03-07,7,6409,4,2867,3,3542,0,0,5,2187,2,2110,5,4297,California
Inyo,2021-03-08,173,6582,5,2872,168,3710,0,0,84,2182,89,2199,84,4381,California
Inyo,2021-03-09,179,6761,3,2875,176,3886,0,0,63,2129,116,2315,63,4444,California
Inyo,2021-03-10,67,6828,9,2884,57,3943,1,1,24,2111,43,2358,25,4469,California
Inyo,2021-03-11,179,7007,2,2886,171,4114,6,7,66,2070,112,2470,71,4540,California
Inyo,2021-03-12,100,7107,4,2890,91,4205,5,12,29,2033,71,2541,34,4574,California
Inyo,2021-03-13,559,7666,528,3418,22,4227,9,21,70,1623,489,3030,79,4653,California
Inyo,2021-03-14,431,8097,429,3847,2,4229,0,21,169,1530,262,3292,169,4822,California
Inyo,2021-03-15,51,8148,15,3862,34,4263,2,23,29,1539,22,3314,31,4853,California
Inyo,2021-03-16,147,8295,4,3866,138,4401,5,28,49,1495,98,3412,54,4907,California
Inyo,2021-03-17,81,8376,2,3868,75,4476,4,32,71,1560,10,3422,75,4982,California
Inyo,2021-03-18,72,8448,15,3883,53,4529,4,36,16,1524,56,3478,20,5002,California
Inyo,2021-03-19,12,8460,1,3884,11,4540,0,36,9,1530,3,3481,9,5011,California
Mariposa,2020-12-17,2,2,2,2,0,0,0,0,38,38,0,0,38,38,California
Mariposa,2020-12-18,5,7,5,7,0,0,0,0,56,94,0,0,56,94,California
Mariposa,2020-12-20,2,9,2,9,0,0,0,0,2,96,0,0,2,96,California
Mariposa,2020-12-21,3,12,3,12,0,0,0,0,45,141,0,0,45,141,California
Mariposa,2020-12-22,2,14,1,13,1,1,0,0,2,143,0,0,2,143,California
Mariposa,2020-12-23,11,25,11,24,0,1,0,0,2,145,0,0,2,145,California
Mariposa,2020-12-26,1,26,1,25,0,1,0,0,1,146,0,0,1,146,California
Mariposa,2020-12-27,1,27,0,25,1,2,0,0,1,147,0,0,1,147,California
Mariposa,2020-12-28,4,31,1,26,3,5,0,0,4,151,0,0,4,151,California
Mariposa,2020-12-29,27,58,1,27,26,31,0,0,27,178,0,0,27,178,California
Mariposa,2020-12-30,21,79,0,27,21,52,0,0,21,199,0,0,21,199,California
Mariposa,2020-12-31,16,95,0,27,16,68,0,0,16,215,0,0,16,215,California
Mariposa,2021-01-04,9,104,1,28,8,76,0,0,9,224,0,0,9,224,California
Mariposa,2021-01-05,24,128,14,42,10,86,0,0,12,226,10,10,12,236,California
Mariposa,2021-01-06,5,133,3,45,2,88,0,0,2,225,3,13,2,238,California
Mariposa,2021-01-07,49,182,47,92,2,90,0,0,2,180,47,60,2,240,California
Mariposa,2021-01-08,109,291,81,173,28,118,0,0,32,136,77,137,33,273,California
Mariposa,2021-01-09,1,292,0,173,1,119,0,0,1,137,0,137,1,274,California
Mariposa,2021-01-11,23,315,3,176,20,139,0,0,21,156,2,139,21,295,California
Mariposa,2021-01-12,18,333,3,179,15,154,0,0,15,168,3,142,15,310,California
Mariposa,2021-01-13,21,354,1,180,20,174,0,0,20,187,1,143,20,330,California
Mariposa,2021-01-14,76,430,2,182,74,248,0,0,75,261,1,144,75,405,California
Mariposa,2021-01-15,46,476,1,183,45,293,0,0,45,305,1,145,45,450,California
Mariposa,2021-01-16,18,494,1,184,17,310,0,0,17,321,1,146,17,467,California
Mariposa,2021-01-17,2,496,0,184,2,312,0,0,2,323,0,146,2,469,California
Mariposa,2021-01-18,2,498,2,186,0,312,0,0,1,323,1,147,1,470,California
Mariposa,2021-01-19,1,499,0,186,1,313,0,0,1,324,0,147,1,471,California
Mariposa,2021-01-20,27,526,0,186,27,340,0,0,26,350,0,147,26,497,California
Mariposa,2021-01-21,88,614,2,188,86,426,0,0,88,438,0,147,88,585,California
Mariposa,2021-01-22,76,690,1,189,75,501,0,0,76,514,0,147,76,661,California
Mariposa,2021-01-23,125,815,0,189,125,626,0,0,124,638,0,147,124,785,California
Mariposa,2021-01-25,4,819,1,190,3,629,0,0,0,634,4,151,0,785,California
Mariposa,2021-01-26,32,851,2,192,30,659,0,0,3,608,29,180,3,788,California
Mariposa,2021-01-27,34,885,1,193,33,692,0,0,26,626,8,188,26,814,California
Mariposa,2021-01-28,147,1032,2,195,145,837,0,0,133,745,14,202,133,947,California
Mariposa,2021-01-29,57,1089,0,195,57,894,0,0,57,802,0,202,57,1004,California
Mariposa,2021-01-30,3,1092,1,196,2,896,0,0,2,803,1,203,2,1006,California
Mariposa,2021-01-31,1,1093,0,196,1,897,0,0,1,804,0,203,1,1007,California
Mariposa,2021-02-01,56,1149,1,197,55,952,0,0,49,846,7,210,49,1056,California
Mariposa,2021-02-02,8,1157,0,197,8,960,0,0,2,842,6,216,2,1058,California
Mariposa,2021-02-03,26,1183,1,198,25,985,0,0,22,860,4,220,22,1080,California
Mariposa,2021-02-04,115,1298,7,205,108,1093,0,0,108,964,4,224,108,1188,California
Mariposa,2021-02-05,239,1537,4,209,235,1328,0,0,216,1158,23,247,217,1405,California
Mariposa,2021-02-06,1,1538,0,209,1,1329,0,0,1,1159,0,247,1,1406,California
Mariposa,2021-02-08,39,1577,1,210,38,1367,0,0,20,1161,19,266,21,1427,California
Mariposa,2021-02-09,9,1586,3,213,6,1373,0,0,4,1160,5,271,4,1431,California
Mariposa,2021-02-10,17,1603,1,214,16,1389,0,0,9,1161,8,279,9,1440,California
Mariposa,2021-02-11,381,1984,5,219,376,1765,0,0,336,1486,44,323,369,1809,California
Mariposa,2021-02-12,178,2162,2,221,176,1941,0,0,116,1558,62,385,134,1943,California
Mariposa,2021-02-13,5,2167,3,224,2,1943,0,0,4,1561,1,386,4,1947,California
Mariposa,2021-02-14,6,2173,3,227,3,1946,0,0,4,1564,2,388,5,1952,California
Mariposa,2021-02-15,8,2181,2,229,6,1952,0,0,7,1570,1,389,7,1959,California
Mariposa,2021-02-16,19,2200,2,231,17,1969,0,0,8,1577,11,400,18,1977,California
Mariposa,2021-02-17,21,2221,2,233,19,1988,0,0,9,1582,11,411,16,1993,California
Mariposa,2021-02-18,56,2277,3,236,53,2041,0,0,13,1552,43,454,13,2006,California
Mariposa,2021-02-19,74,2351,0,236,74,2115,0,0,33,1584,41,495,73,2079,California
Mariposa,2021-02-20,253,2604,4,240,249,2364,0,0,168,1720,85,580,221,2300,California
Mariposa,2021-02-21,232,2836,2,242,230,2594,0,0,231,1950,1,581,231,2531,California
Mariposa,2021-02-22,15,2851,2,244,13,2607,0,0,15,1965,0,581,15,2546,California
Mariposa,2021-02-23,4,2855,1,245,3,2610,0,0,3,1967,1,582,3,2549,California
Mariposa,2021-02-24,20,2875,2,247,18,2628,0,0,4,1955,16,598,4,2553,California
Mariposa,2021-02-25,4,2879,3,250,1,2629,0,0,2,1955,2,600,2,2555,California
Mariposa,2021-02-26,411,3290,3,253,408,3037,0,0,252,2153,159,759,357,2912,California
Mariposa,2021-02-27,154,3444,3,256,151,3188,0,0,150,2300,4,763,151,3063,California
Mariposa,2021-02-28,2,3446,1,257,1,3189,0,0,0,2298,2,765,0,3063,California
Mariposa,2021-03-01,56,3502,3,260,53,3242,0,0,8,2259,48,813,9,3072,California
Mariposa,2021-03-02,6,3508,5,265,1,3243,0,0,3,2259,3,816,3,3075,California
Mariposa,2021-03-03,65,3573,1,266,64,3307,0,0,63,2320,2,818,63,3138,California
Mariposa,2021-03-04,16,3589,6,272,10,3317,0,0,6,2319,10,828,9,3147,California
Mariposa,2021-03-05,36,3625,7,279,29,3346,0,0,25,2337,11,839,29,3176,California
Mariposa,2021-03-06,5,3630,2,281,3,3349,0,0,5,2342,0,839,5,3181,California
Mariposa,2021-03-07,1,3631,1,282,0,3349,0,0,0,2341,1,840,0,3181,California
Mariposa,2021-03-08,36,3667,2,284,23,3372,11,11,7,2330,29,869,18,3199,California
Mariposa,2021-03-09,23,3690,2,286,10,3382,11,22,8,2334,15,884,19,3218,California
Mariposa,2021-03-10,16,3706,4,290,3,3385,9,31,4,2335,12,896,13,3231,California
Mariposa,2021-03-11,458,4164,6,296,434,3819,18,49,174,2293,283,1179,241,3472,California
Mariposa,2021-03-12,244,4408,2,298,213,4032,29,78,98,2284,146,1325,137,3609,California
Mariposa,2021-03-13,22,4430,3,301,4,4036,15,93,4,2286,18,1343,20,3629,California
Mariposa,2021-03-14,14,4444,0,301,3,4039,11,104,2,2287,12,1355,13,3642,California
Mariposa,2021-03-15,71,4515,5,306,28,4067,38,142,27,2308,44,1399,65,3707,California
Mariposa,2021-03-16,44,4559,5,311,5,4072,34,176,7,2312,37,1436,41,3748,California
Mariposa,2021-03-17,51,4610,6,317,40,4112,5,181,44,2356,7,1443,51,3799,California
Mariposa,2021-03-18,38,4648,3,320,27,4139,8,189,28,2382,10,1453,36,3835,California
Mariposa,2021-03-19,51,4699,1,321,41,4180,9,198,27,2394,24,1477,36,3871,California
Orange,2020-12-15,16,16,16,16,0,0,0,0,16,16,0,0,16,16,California
Orange,2020-12-16,365,381,365,381,0,0,0,0,365,381,0,0,365,381,California
Orange,2020-12-17,3694,4075,3694,4075,0,0,0,0,3693,4074,0,0,3693,4074,California
Orange,2020-12-18,4994,9069,4987,9062,7,7,0,0,4993,9067,0,0,4993,9067,California
Orange,2020-12-19,2189,11258,2182,11244,7,14,0,0,2188,11255,0,0,2188,11255,California
Orange,2020-12-20,1955,13213,1955,13199,0,14,0,0,1956,13211,0,0,1956,13211,California
Orange,2020-12-21,4199,17412,4194,17393,5,19,0,0,4199,17410,0,0,4199,17410,California
Orange,2020-12-22,3941,21353,3908,21301,33,52,0,0,3941,21351,0,0,3941,21351,California
Orange,2020-12-23,3511,24864,3162,24463,349,401,0,0,3513,24864,0,0,3513,24864,California
Orange,2020-12-24,1345,26209,1066,25529,279,680,0,0,1345,26209,0,0,1345,26209,California
Orange,2020-12-25,14,26223,10,25539,4,684,0,0,14,26223,0,0,14,26223,California
Orange,2020-12-26,1052,27275,422,25961,630,1314,0,0,1052,27275,0,0,1052,27275,California
Orange,2020-12-27,581,27856,274,26235,307,1621,0,0,581,27856,0,0,581,27856,California
Orange,2020-12-28,3521,31377,2561,28796,960,2581,0,0,3521,31377,0,0,3521,31377,California
Orange,2020-12-29,3542,34919,2557,31353,985,3566,0,0,3542,34919,0,0,3542,34919,California
Orange,2020-12-30,5091,40010,3546,34899,1545,5111,0,0,5091,40010,0,0,5091,40010,California
Orange,2020-12-31,1450,41460,758,35657,692,5803,0,0,1450,41460,0,0,1450,41460,California
Orange,2021-01-01,379,41839,217,35874,162,5965,0,0,378,41837,1,1,378,41838,California
Orange,2021-01-02,1388,43227,891,36765,497,6462,0,0,1388,43225,0,1,1388,43226,California
Orange,2021-01-03,543,43770,299,37064,244,6706,0,0,543,43768,0,1,543,43769,California
Orange,2021-01-04,2668,46438,1544,38608,1124,7830,0,0,2669,46436,1,2,2669,46438,California
Orange,2021-01-05,3474,49912,2280,40888,1194,9024,0,0,3063,49098,404,406,3066,49504,California
Orange,2021-01-06,4938,54850,3434,44322,1504,10528,0,0,3580,51333,1345,1751,3580,53084,California
Orange,2021-01-07,9170,64020,5104,49426,4066,14594,0,0,5633,53446,3524,5275,5637,58721,California
Orange,2021-01-08,9310,73330,5199,54625,4111,18705,0,0,5598,55345,3702,8977,5601,64322,California
Orange,2021-01-09,4957,78287,1723,56348,3234,21939,0,0,3685,57759,1272,10249,3686,68008,California
Orange,2021-01-10,4186,82473,1030,57378,3156,25095,0,0,3313,60203,873,11122,3317,71325,California
Orange,2021-01-11,9314,91787,4849,62227,4465,29560,0,0,5722,62331,3595,14717,5723,77048,California
Orange,2021-01-12,8674,100461,4663,66890,4011,33571,0,0,5246,64151,3426,18143,5246,82294,California
Orange,2021-01-13,10091,110552,4833,71723,5258,38829,0,0,6936,67943,3152,21295,6944,89238,California
Orange,2021-01-14,9834,120386,3737,75460,6097,44926,0,0,8266,74647,1567,22862,8271,97509,California
Orange,2021-01-15,10008,130394,2579,78039,7429,52355,0,0,9138,82913,877,23739,9143,106652,California
Orange,2021-01-16,8598,138992,2085,80124,6513,58868,0,0,8218,90755,380,24119,8222,114874,California
Orange,2021-01-17,8124,147116,1509,81633,6615,65483,0,0,7981,98601,142,24261,7988,122862,California
Orange,2021-01-18,9714,156830,4460,86093,5254,70737,0,0,7484,103853,2234,26495,7486,130348,California
Orange,2021-01-19,7380,164210,5353,91446,2027,72764,0,0,4771,106016,2610,29105,4773,135121,California
Orange,2021-01-20,8161,172371,5744,97190,2417,75181,0,0,5117,108094,3044,32149,5122,140243,California
Orange,2021-01-21,10748,183119,4760,101950,5988,81169,0,0,9965,117285,782,32931,9973,150216,California
Orange,2021-01-22,13484,196603,5041,106991,8443,89612,0,0,12673,129161,804,33735,12680,162896,California
Orange,2021-01-23,13113,209716,6183,113174,6930,96542,0,0,12156,140367,955,34690,12161,175057,California
Orange,2021-01-24,9826,219542,4305,117479,5521,102063,0,0,9519,149588,305,34995,9526,184583,California
Orange,2021-01-25,10330,229872,5784,123263,4546,106609,0,0,7648,154610,2675,37670,7697,192280,California
Orange,2021-01-26,11659,241531,7611,130874,4048,110657,0,0,9544,162043,2112,39782,9545,201825,California
Orange,2021-01-27,13275,254806,7921,138795,5354,116011,0,0,10638,170058,2626,42408,10641,212466,California
Orange,2021-01-28,12813,267619,7019,145814,5794,121805,0,0,11018,179300,1782,44190,11024,223490,California
Orange,2021-01-29,13462,281081,8321,154135,5141,126946,0,0,10671,187193,2781,46971,10674,234164,California
Orange,2021-01-30,12867,293948,4417,158552,8450,135396,0,0,12158,198656,697,47668,12160,246324,California
Orange,2021-01-31,13748,307696,4948,163500,8800,144196,0,0,13347,211607,398,48066,13349,259673,California
Orange,2021-02-01,13849,321545,5674,169174,8175,152371,0,0,11931,221638,1902,49968,11933,271606,California
Orange,2021-02-02,15269,336814,8313,177487,6956,159327,0,0,12589,231659,2571,52539,12592,284198,California
Orange,2021-02-03,16700,353514,12498,189985,4202,163529,0,0,13741,242520,2883,55422,13744,297942,California
Orange,2021-02-04,19611,373125,12773,202758,6838,170367,0,0,14602,252147,4979,60401,14606,312548,California
Orange,2021-02-05,20610,393735,11933,214691,8677,179044,0,0,14455,260487,6119,66520,14459,327007,California
Orange,2021-02-06,16281,410016,10746,225437,5535,184579,0,0,11068,266358,5199,71719,11070,338077,California
Orange,2021-02-07,11513,421529,8054,233491,3459,188038,0,0,7589,270036,3911,75630,7589,345666,California
Orange,2021-02-08,14587,436116,8409,241900,6178,194216,0,0,8737,272950,5825,81455,8739,354405,California
Orange,2021-02-09,17352,453468,11843,253743,5509,199725,0,0,10663,276998,6619,88074,10667,365072,California
Orange,2021-02-10,20680,474148,11033,264776,9647,209372,0,0,12662,281740,7926,96000,12668,377740,California
Orange,2021-02-11,21657,495805,11176,275952,10481,219853,0,0,12235,284713,9284,105284,12257,389997,California
Orange,2021-02-12,24506,520311,11794,287746,12712,232565,0,0,14549,289360,9911,115195,14558,404555,California
Orange,2021-02-13,21545,541856,11527,299273,10018,242583,0,0,11131,290288,10215,125410,11143,415698,California
Orange,2021-02-14,16089,557945,6550,305823,9539,252122,0,0,9517,293253,6554,131964,9519,425217,California
Orange,2021-02-15,16976,574921,7303,313126,9673,261795,0,0,8851,294019,8094,140058,8860,434077,California
Orange,2021-02-16,19497,594418,8786,321912,10711,272506,0,0,10583,295728,8884,148942,10593,444670,California
Orange,2021-02-17,17113,611531,8973,330885,8140,280646,0,0,8989,296632,8092,157034,8996,453666,California
Orange,2021-02-18,13687,625218,8953,339838,4734,285380,0,0,6364,295715,7289,164323,6372,460038,California
Orange,2021-02-19,17288,642506,10514,350352,6774,292154,0,0,6759,291986,10495,174818,6766,466804,California
Orange,2021-02-20,6702,649208,5299,355651,1403,293557,0,0,3203,291713,3483,178301,3210,470014,California
Orange,2021-02-21,3806,653014,3196,358847,610,294167,0,0,660,289244,3130,181431,661,470675,California
Orange,2021-02-22,9130,662144,7534,366381,1596,295763,0,0,3704,287550,5409,186840,3715,474390,California
Orange,2021-02-23,12770,674914,6946,373327,5824,301587,0,0,3366,281555,9370,196210,3375,477765,California
Orange,2021-02-24,20131,695045,12197,385524,7934,309521,0,0,5022,271526,15067,211277,5038,482803,California
Orange,2021-02-25,21746,716791,11758,397282,9988,319509,0,0,7718,265277,13986,225263,7737,490540,California
Orange,2021-02-26,26297,743088,13297,410579,13000,332509,0,0,10601,260284,15618,240881,10625,501165,California
Orange,2021-02-27,24483,767571,9935,420514,14548,347057,0,0,7174,250246,17230,258111,7192,508357,California
Orange,2021-02-28,18321,785892,7066,427580,11255,358312,0,0,4372,240737,13893,272004,4384,512741,California
Orange,2021-03-01,17521,803413,8056,435636,9464,367776,1,1,6706,236695,10774,282778,6732,519473,California
Orange,2021-03-02,13596,817009,6707,442343,6888,374664,1,2,8164,239477,5409,288187,8191,527664,California
Orange,2021-03-03,18250,835259,8587,450930,9663,384327,0,2,9410,240119,8785,296972,9427,537091,California
Orange,2021-03-04,18759,854018,11291,462221,7466,391793,2,4,9846,241098,8894,305866,9873,546964,California
Orange,2021-03-05,16941,870959,9013,471234,7890,399683,38,42,10602,245448,6321,312187,10671,557635,California
Orange,2021-03-06,18015,888974,10066,481300,7131,406814,818,860,9481,247259,8512,320699,10323,567958,California
Orange,2021-03-07,13964,902938,7991,489291,5623,412437,350,1210,8131,249942,5811,326510,8494,576452,California
Orange,2021-03-08,13651,916589,6194,495485,6528,418965,929,2139,8963,255182,4671,331181,9911,586363,California
Orange,2021-03-09,18766,935355,7872,503357,8522,427487,2372,4511,10713,260247,8030,339211,13095,599458,California
Orange,2021-03-10,18903,954258,9360,512717,6870,434357,2673,7184,9809,263667,9068,348279,12488,611946,California
Orange,2021-03-11,26814,981072,14472,527189,8616,442973,3726,10910,12517,265812,14256,362535,16401,628347,California
Orange,2021-03-12,23698,1004770,11533,538722,9180,452153,2985,13895,11865,268868,11802,374337,14858,643205,California
Orange,2021-03-13,18863,1023633,7091,545813,9283,461436,2489,16384,9287,271098,9560,383897,11790,654995,California
Orange,2021-03-14,16096,1039729,7242,553055,6535,467971,2319,18703,10380,278107,5700,389597,12709,667704,California
Orange,2021-03-15,22134,1061863,9576,562631,11915,479886,643,19346,14167,284985,7946,397543,14824,682528,California
Orange,2021-03-16,25592,1087455,10770,573401,14588,494474,234,19580,16787,293262,8759,406302,17036,699564,California
Orange,2021-03-17,23723,1111178,12027,585428,11471,505945,225,19805,17199,304208,6493,412795,17439,717003,California
Orange,2021-03-18,13966,1125144,7212,592640,6662,512607,92,19897,10717,311808,3221,416016,10821,727824,California
Orange,2021-03-19,11323,1136467,5909,598549,5336,517943,78,19975,8537,317668,2769,418785,8629,736453,California
Lake,2020-12-17,4,4,4,4,0,0,0,0,4,4,0,0,4,4,California
Lake,2020-12-18,51,55,51,55,0,0,0,0,51,55,0,0,51,55,California
Lake,2020-12-19,3,58,3,58,0,0,0,0,3,58,0,0,3,58,California
Lake,2020-12-20,6,64,6,64,0,0,0,0,6,64,0,0,6,64,California
Lake,2020-12-21,50,114,50,114,0,0,0,0,50,114,0,0,50,114,California
Lake,2020-12-22,63,177,60,174,3,3,0,0,63,177,0,0,63,177,California
Lake,2020-12-23,91,268,83,257,8,11,0,0,91,268,0,0,91,268,California
Lake,2020-12-24,2,270,0,257,2,13,0,0,2,270,0,0,2,270,California
Lake,2020-12-26,2,272,2,259,0,13,0,0,2,272,0,0,2,272,California
Lake,2020-12-27,2,274,2,261,0,13,0,0,2,274,0,0,2,274,California
Lake,2020-12-28,52,326,43,304,9,22,0,0,52,326,0,0,52,326,California
Lake,2020-12-29,14,340,9,313,5,27,0,0,14,340,0,0,14,340,California
Lake,2020-12-30,89,429,82,395,7,34,0,0,89,429,0,0,89,429,California
Lake,2020-12-31,67,496,64,459,3,37,0,0,67,496,0,0,67,496,California
Lake,2021-01-01,1,497,0,459,1,38,0,0,1,497,0,0,1,497,California
Lake,2021-01-02,2,499,1,460,1,39,0,0,2,499,0,0,2,499,California
Lake,2021-01-04,64,563,1,461,63,102,0,0,64,563,0,0,64,563,California
Lake,2021-01-05,80,643,59,520,21,123,0,0,78,639,2,2,78,641,California
Lake,2021-01-06,83,726,65,585,18,141,0,0,81,718,2,4,81,722,California
Lake,2021-01-07,69,795,49,634,20,161,0,0,65,779,4,8,65,787,California
Lake,2021-01-08,143,938,124,758,19,180,0,0,91,818,52,60,91,878,California
Lake,2021-01-09,62,1000,60,818,2,182,0,0,58,872,4,64,58,936,California
Lake,2021-01-10,3,1003,3,821,0,182,0,0,0,869,3,67,0,936,California
Lake,2021-01-11,160,1163,119,940,41,223,0,0,112,933,48,115,112,1048,California
Lake,2021-01-12,79,1242,48,988,31,254,0,0,55,964,24,139,55,1103,California
Lake,2021-01-13,125,1367,73,1061,52,306,0,0,96,1031,29,168,96,1199,California
Lake,2021-01-14,136,1503,35,1096,101,407,0,0,115,1125,21,189,115,1314,California
Lake,2021-01-15,216,1719,93,1189,123,530,0,0,189,1287,27,216,189,1503,California
Lake,2021-01-16,135,1854,83,1272,52,582,0,0,133,1418,2,218,133,1636,California
Lake,2021-01-17,18,1872,6,1278,12,594,0,0,12,1424,6,224,12,1648,California
Lake,2021-01-18,243,2115,224,1502,19,613,0,0,125,1431,118,342,125,1773,California
Lake,2021-01-19,277,2392,84,1586,193,806,0,0,263,1681,14,356,264,2037,California
Lake,2021-01-20,385,2777,44,1630,341,1147,0,0,356,2008,29,385,356,2393,California
Lake,2021-01-21,316,3093,48,1678,268,1415,0,0,283,2258,33,418,283,2676,California
Lake,2021-01-22,318,3411,45,1723,273,1688,0,0,282,2504,36,454,282,2958,California
Lake,2021-01-23,123,3534,5,1728,118,1806,0,0,122,2625,1,455,122,3080,California
Lake,2021-01-24,4,3538,1,1729,3,1809,0,0,4,2629,0,455,4,3084,California
Lake,2021-01-25,231,3769,73,1802,158,1967,0,0,173,2744,58,513,173,3257,California
Lake,2021-01-26,424,4193,35,1837,389,2356,0,0,401,3122,23,536,401,3658,California
Lake,2021-01-27,357,4550,39,1876,318,2674,0,0,331,3427,26,562,331,3989,California
Lake,2021-01-28,466,5016,130,2006,336,3010,0,0,365,3691,101,663,365,4354,California
Lake,2021-01-29,633,5649,81,2087,552,3562,0,0,574,4206,59,722,574,4928,California
Lake,2021-01-30,557,6206,45,2132,512,4074,0,0,550,4750,7,729,551,5479,California
Lake,2021-01-31,15,6221,8,2140,7,4081,0,0,14,4763,1,730,14,5493,California
Lake,2021-02-01,176,6397,17,2157,159,4240,0,0,165,4917,11,741,165,5658,California
Lake,2021-02-02,537,6934,154,2311,383,4623,0,0,400,5180,137,878,400,6058,California
Lake,2021-02-03,419,7353,24,2335,395,5018,0,0,348,5457,71,949,348,6406,California
Lake,2021-02-04,99,7452,54,2389,45,5063,0,0,71,5500,28,977,71,6477,California
Lake,2021-02-05,368,7820,68,2457,300,5363,0,0,288,5710,78,1055,288,6765,California
Lake,2021-02-06,281,8101,43,2500,238,5601,0,0,269,5967,12,1067,269,7034,California
Lake,2021-02-07,2,8103,1,2501,1,5602,0,0,2,5969,0,1067,2,7036,California
Lake,2021-02-08,275,8378,206,2707,69,5671,0,0,157,6008,118,1185,157,7193,California
Lake,2021-02-09,339,8717,21,2728,318,5989,0,0,300,6269,39,1224,300,7493,California
Lake,2021-02-10,351,9068,52,2780,299,6288,0,0,273,6464,78,1302,273,7766,California
Lake,2021-02-11,171,9239,19,2799,152,6440,0,0,60,6413,111,1413,60,7826,California
Lake,2021-02-12,369,9608,27,2826,342,6782,0,0,283,6610,86,1499,283,8109,California
Lake,2021-02-13,253,9861,8,2834,245,7027,0,0,242,6841,11,1510,242,8351,California
Lake,2021-02-14,21,9882,4,2838,17,7044,0,0,8,6836,13,1523,8,8359,California
Lake,2021-02-15,171,10053,12,2850,159,7203,0,0,7,6680,163,1686,7,8366,California
Lake,2021-02-16,407,10460,15,2865,392,7595,0,0,168,6609,239,1925,168,8534,California
Lake,2021-02-17,350,10810,54,2919,296,7891,0,0,72,6404,277,2202,72,8606,California
Lake,2021-02-18,445,11255,66,2985,379,8270,0,0,115,6189,330,2532,115,8721,California
Lake,2021-02-19,405,11660,26,3011,379,8649,0,0,89,5962,316,2848,89,8810,California
Lake,2021-02-20,263,11923,54,3065,209,8858,0,0,224,6147,39,2887,224,9034,California
Lake,2021-02-21,6,11929,6,3071,0,8858,0,0,0,6141,6,2893,0,9034,California
Lake,2021-02-22,136,12065,22,3093,114,8972,0,0,41,6087,95,2988,41,9075,California
Lake,2021-02-23,208,12273,12,3105,196,9168,0,0,24,5927,184,3172,24,9099,California
Lake,2021-02-24,756,13029,370,3475,386,9554,0,0,408,5987,348,3520,408,9507,California
Lake,2021-02-25,710,13739,445,3920,265,9819,0,0,470,6219,238,3758,470,9977,California
Lake,2021-02-26,990,14729,305,4225,685,10504,0,0,345,5924,640,4398,345,10322,California
Lake,2021-02-27,338,15067,35,4260,303,10807,0,0,313,6212,25,4423,313,10635,California
Lake,2021-02-28,17,15084,12,4272,5,10812,0,0,9,6213,8,4431,9,10644,California
Lake,2021-03-01,592,15676,53,4325,539,11351,0,0,440,6501,152,4583,440,11084,California
Lake,2021-03-02,744,16420,14,4339,730,12081,0,0,285,6327,459,5042,285,11369,California
Lake,2021-03-03,344,16764,192,4531,152,12233,0,0,124,6231,220,5262,124,11493,California
Lake,2021-03-04,535,17299,466,4997,69,12302,0,0,522,6740,13,5275,522,12015,California
Lake,2021-03-05,813,18112,27,5024,786,13088,0,0,115,6160,695,5970,115,12130,California
Lake,2021-03-06,37,18149,9,5033,27,13115,1,1,23,6170,14,5984,24,12154,California
Lake,2021-03-07,7,18156,5,5038,2,13117,0,1,3,6169,4,5988,3,12157,California
Lake,2021-03-08,294,18450,244,5282,41,13158,9,10,272,6428,22,6010,281,12438,California
Lake,2021-03-09,887,19337,28,5310,850,14008,9,19,375,6301,511,6521,384,12822,California
Lake,2021-03-10,188,19525,54,5364,128,14136,6,25,132,6383,56,6577,138,12960,California
Lake,2021-03-11,539,20064,49,5413,62,14198,428,453,51,6374,488,7065,479,13439,California
Lake,2021-03-12,767,20831,147,5560,596,14794,24,477,302,6236,464,7529,326,13765,California
Lake,2021-03-13,180,21011,19,5579,18,14812,143,620,17,6234,161,7690,159,13924,California
Lake,2021-03-14,13,21024,3,5582,9,14821,1,621,8,6238,5,7695,9,13933,California
Lake,2021-03-15,506,21530,11,5593,475,15296,20,641,377,6506,129,7824,397,14330,California
Lake,2021-03-16,1046,22576,791,6384,238,15534,17,658,420,6320,623,8447,437,14767,California
Lake,2021-03-17,203,22779,100,6484,93,15627,10,668,75,6277,128,8575,85,14852,California
Lake,2021-03-18,357,23136,180,6664,174,15801,3,671,198,6319,159,8734,201,15053,California
Lake,2021-03-19,283,23419,152,6816,127,15928,4,675,252,6545,30,8764,256,15309,California
Santa Cruz,2020-12-15,2,2,2,2,0,0,0,0,2,2,0,0,2,2,California
Santa Cruz,2020-12-16,57,59,57,59,0,0,0,0,57,59,0,0,57,59,California
Santa Cruz,2020-12-17,389,448,389,448,0,0,0,0,389,448,0,0,389,448,California
Santa Cruz,2020-12-18,466,914,466,914,0,0,0,0,466,914,0,0,466,914,California
Santa Cruz,2020-12-19,176,1090,175,1089,1,1,0,0,176,1090,0,0,176,1090,California
Santa Cruz,2020-12-20,95,1185,95,1184,0,1,0,0,95,1185,0,0,95,1185,California
Santa Cruz,2020-12-21,428,1613,428,1612,0,1,0,0,428,1613,0,0,428,1613,California
Santa Cruz,2020-12-22,423,2036,422,2034,1,2,0,0,423,2036,0,0,423,2036,California
Santa Cruz,2020-12-23,372,2408,330,2364,42,44,0,0,372,2408,0,0,372,2408,California
Santa Cruz,2020-12-24,125,2533,50,2414,75,119,0,0,125,2533,0,0,125,2533,California
Santa Cruz,2020-12-25,11,2544,11,2425,0,119,0,0,11,2544,0,0,11,2544,California
Santa Cruz,2020-12-26,64,2608,45,2470,19,138,0,0,64,2608,0,0,64,2608,California
Santa Cruz,2020-12-27,32,2640,27,2497,5,143,0,0,32,2640,0,0,32,2640,California
Santa Cruz,2020-12-28,482,3122,107,2604,375,518,0,0,482,3122,0,0,482,3122,California
Santa Cruz,2020-12-29,791,3913,365,2969,426,944,0,0,791,3913,0,0,791,3913,California
Santa Cruz,2020-12-30,357,4270,165,3134,192,1136,0,0,357,4270,0,0,357,4270,California
Santa Cruz,2020-12-31,313,4583,11,3145,302,1438,0,0,313,4583,0,0,313,4583,California
Santa Cruz,2021-01-01,32,4615,0,3145,32,1470,0,0,32,4615,0,0,32,4615,California
Santa Cruz,2021-01-02,68,4683,56,3201,12,1482,0,0,68,4683,0,0,68,4683,California
Santa Cruz,2021-01-03,15,4698,7,3208,8,1490,0,0,15,4698,0,0,15,4698,California
Santa Cruz,2021-01-04,280,4978,123,3331,157,1647,0,0,278,4975,1,1,278,4976,California
Santa Cruz,2021-01-05,565,5543,428,3759,137,1784,0,0,263,4936,302,303,263,5239,California
Santa Cruz,2021-01-06,804,6347,670,4429,134,1918,0,0,466,5065,337,640,466,5705,California
Santa Cruz,2021-01-07,532,6879,210,4639,322,2240,0,0,381,5296,151,791,382,6087,California
Santa Cruz,2021-01-08,934,7813,562,5201,372,2612,0,0,485,5334,448,1239,486,6573,California
Santa Cruz,2021-01-09,461,8274,121,5322,340,2952,0,0,409,5691,52,1291,409,6982,California
Santa Cruz,2021-01-10,72,8346,62,5384,10,2962,0,0,18,5655,54,1345,18,7000,California
Santa Cruz,2021-01-11,713,9059,580,5964,133,3095,0,0,191,5324,522,1867,191,7191,California
Santa Cruz,2021-01-12,734,9793,529,6493,205,3300,0,0,492,5574,242,2109,492,7683,California
Santa Cruz,2021-01-13,519,10312,226,6719,293,3593,0,0,435,5928,81,2190,435,8118,California
Santa Cruz,2021-01-14,540,10852,90,6809,450,4043,0,0,483,6354,57,2247,483,8601,California
Santa Cruz,2021-01-15,1463,12315,90,6899,1373,5416,0,0,1388,7669,74,2321,1389,9990,California
Santa Cruz,2021-01-16,435,12750,63,6962,372,5788,0,0,408,8050,27,2348,408,10398,California
Santa Cruz,2021-01-17,284,13034,31,6993,253,6041,0,0,266,8298,18,2366,266,10664,California
Santa Cruz,2021-01-18,1026,14060,113,7106,913,6954,0,0,957,9186,69,2435,957,11621,California
Santa Cruz,2021-01-19,1618,15678,521,7627,1097,8051,0,0,1268,10107,348,2783,1269,12890,California
Santa Cruz,2021-01-20,1226,16904,182,7809,1044,9095,0,0,1031,10946,192,2975,1031,13921,California
Santa Cruz,2021-01-21,1697,18601,197,8006,1500,10595,0,0,1593,12436,104,3079,1594,15515,California
Santa Cruz,2021-01-22,1795,20396,533,8539,1262,11857,0,0,1691,14027,101,3180,1692,17207,California
Santa Cruz,2021-01-23,401,20797,143,8682,258,12115,0,0,342,14311,58,3238,342,17549,California
Santa Cruz,2021-01-24,114,20911,21,8703,93,12208,0,0,95,14387,19,3257,95,17644,California
Santa Cruz,2021-01-25,1054,21965,357,9060,697,12905,0,0,547,14428,507,3764,548,18192,California
Santa Cruz,2021-01-26,1670,23635,246,9306,1424,14329,0,0,1160,15078,510,4274,1160,19352,California
Santa Cruz,2021-01-27,1638,25273,444,9750,1194,15523,0,0,1255,15951,382,4656,1255,20607,California
Santa Cruz,2021-01-28,1720,26993,271,10021,1449,16972,0,0,1448,17129,271,4927,1449,22056,California
Santa Cruz,2021-01-29,1728,28721,484,10505,1244,18216,0,0,1599,18600,128,5055,1599,23655,California
Santa Cruz,2021-01-30,1047,29768,295,10800,752,18968,0,0,924,19401,123,5178,924,24579,California
Santa Cruz,2021-01-31,227,29995,122,10922,105,19073,0,0,202,19578,25,5203,202,24781,California
Santa Cruz,2021-02-01,1226,31221,756,11678,470,19543,0,0,820,19992,406,5609,820,25601,California
Santa Cruz,2021-02-02,1008,32229,131,11809,877,20420,0,0,855,20695,152,5761,855,26456,California
Santa Cruz,2021-02-03,2188,34417,938,12747,1250,21670,0,0,1880,22271,304,6065,1880,28336,California
Santa Cruz,2021-02-04,1808,36225,771,13518,1037,22707,0,0,1472,23408,335,6400,1472,29808,California
Santa Cruz,2021-02-05,3159,39384,790,14308,2369,25076,0,0,2839,25929,318,6718,2839,32647,California
Santa Cruz,2021-02-06,2578,41962,163,14471,2415,27491,0,0,2230,27811,348,7066,2230,34877,California
Santa Cruz,2021-02-07,907,42869,121,14592,786,28277,0,0,890,28684,17,7083,890,35767,California
Santa Cruz,2021-02-08,705,43574,199,14791,506,28783,0,0,507,28994,197,7280,507,36274,California
Santa Cruz,2021-02-09,2360,45934,1048,15839,1312,30095,0,0,2100,30838,256,7536,2100,38374,California
Santa Cruz,2021-02-10,2182,48116,576,16415,1606,31701,0,0,1492,31644,687,8223,1493,39867,California
Santa Cruz,2021-02-11,1808,49924,300,16715,1508,33209,0,0,1301,32440,506,8729,1302,41169,California
Santa Cruz,2021-02-12,3163,53087,419,17134,2744,35953,0,0,1771,32828,1384,10113,1772,42941,California
Santa Cruz,2021-02-13,1699,54786,120,17254,1579,37532,0,0,1286,33701,413,10526,1286,44227,California
Santa Cruz,2021-02-14,1382,56168,72,17326,1310,38842,0,0,1119,34557,263,10789,1119,45346,California
Santa Cruz,2021-02-15,1572,57740,273,17599,1299,40141,0,0,557,34100,1015,11804,558,45904,California
Santa Cruz,2021-02-16,1671,59411,190,17789,1481,41622,0,0,526,33501,1125,12929,526,46430,California
Santa Cruz,2021-02-17,2900,62311,977,18766,1923,43545,0,0,1217,33051,1670,14599,1220,47650,California
Santa Cruz,2021-02-18,2855,65166,630,19396,2225,45770,0,0,1239,32676,1614,16213,1239,48889,California
Santa Cruz,2021-02-19,3219,68385,1140,20536,2079,47849,0,0,1975,33410,1243,17456,1977,50866,California
Santa Cruz,2021-02-20,2258,70643,1410,21946,848,48697,0,0,1787,34726,471,17927,1787,52653,California
Santa Cruz,2021-02-21,754,71397,294,22240,460,49157,0,0,683,35339,70,17997,683,53336,California
Santa Cruz,2021-02-22,1222,72619,943,23183,279,49436,0,0,519,35157,701,18698,519,53855,California
Santa Cruz,2021-02-23,2091,74710,935,24118,1156,50592,0,0,710,34490,1380,20078,713,54568,California
Santa Cruz,2021-02-24,3100,77810,1598,25716,1502,52094,0,0,1189,33772,1907,21985,1189,55757,California
Santa Cruz,2021-02-25,3156,80966,1413,27129,1743,53837,0,0,1731,34085,1419,23404,1732,57489,California
Santa Cruz,2021-02-26,2630,83596,735,27864,1895,55732,0,0,1479,34415,1149,24553,1479,58968,California
Santa Cruz,2021-02-27,2630,86226,933,28797,1697,57429,0,0,1835,35459,792,25345,1836,60804,California
Santa Cruz,2021-02-28,1274,87500,356,29153,918,58347,0,0,1066,36320,205,25550,1066,61870,California
Santa Cruz,2021-03-01,1784,89284,1242,30395,542,58889,0,0,660,35859,1121,26671,660,62530,California
Santa Cruz,2021-03-02,1432,90716,310,30705,1122,60011,0,0,779,35987,652,27323,780,63310,California
Santa Cruz,2021-03-03,2168,92884,573,31278,1595,61606,0,0,1154,36130,1011,28334,1154,64464,California
Santa Cruz,2021-03-04,2542,95426,1255,32533,1286,62892,1,1,1640,36876,895,29229,1641,66105,California
Santa Cruz,2021-03-05,2279,97705,451,32984,1810,64702,18,19,882,36388,1395,30624,907,67012,California
Santa Cruz,2021-03-06,3682,101387,1294,34278,2288,66990,100,119,1997,36804,1685,32309,2101,69113,California
Santa Cruz,2021-03-07,1339,102726,133,34411,1133,68123,73,192,560,36660,778,33087,634,69747,California
Santa Cruz,2021-03-08,886,103612,214,34625,605,68728,67,259,564,36972,322,33409,634,70381,California
Santa Cruz,2021-03-09,1510,105122,190,34815,1178,69906,142,401,625,36858,881,34290,767,71148,California
Santa Cruz,2021-03-10,3578,108700,1995,36810,1457,71363,126,527,1837,37089,1737,36027,1968,73116,California
Santa Cruz,2021-03-11,2542,111242,1093,37903,1303,72666,146,673,1364,37426,1175,37202,1512,74628,California
Santa Cruz,2021-03-12,2465,113707,821,38724,1396,74062,248,921,812,36836,1651,38853,1061,75689,California
Santa Cruz,2021-03-13,1939,115646,1226,39950,678,74740,35,956,1027,36987,912,39765,1063,76752,California
Santa Cruz,2021-03-14,704,116350,155,40105,535,75275,14,970,352,37003,350,40115,366,77118,California
Santa Cruz,2021-03-15,1310,117660,458,40563,816,76091,36,1006,579,36889,730,40845,616,77734,California
Santa Cruz,2021-03-16,2281,119941,1081,41644,1159,77250,41,1047,1328,37307,952,41797,1370,79104,California
Santa Cruz,2021-03-17,3334,123275,1922,43566,1405,78655,7,1054,2050,38086,1280,43077,2059,81163,California
Santa Cruz,2021-03-18,2098,125373,1146,44712,890,79545,62,1116,1024,38099,1073,44150,1086,82249,California
Santa Cruz,2021-03-19,1392,126765,507,45219,689,80234,196,1312,607,38119,783,44933,803,83052,California
Napa,2020-12-16,12,12,12,12,0,0,0,0,12,12,0,0,12,12,California
Napa,2020-12-17,44,56,44,56,0,0,0,0,44,56,0,0,44,56,California
Napa,2020-12-18,103,159,103,159,0,0,0,0,103,159,0,0,103,159,California
Napa,2020-12-19,221,380,221,380,0,0,0,0,221,380,0,0,221,380,California
Napa,2020-12-20,190,570,190,570,0,0,0,0,190,570,0,0,190,570,California
Napa,2020-12-21,307,877,307,877,0,0,0,0,308,878,0,0,308,878,California
Napa,2020-12-22,335,1212,326,1203,9,9,0,0,335,1213,0,0,335,1213,California
Napa,2020-12-23,428,1640,319,1522,109,118,0,0,428,1641,0,0,428,1641,California
Napa,2020-12-24,138,1778,77,1599,61,179,0,0,138,1779,0,0,138,1779,California
Napa,2020-12-25,1,1779,1,1600,0,179,0,0,1,1780,0,0,1,1780,California
Napa,2020-12-26,39,1818,11,1611,28,207,0,0,39,1819,0,0,39,1819,California
Napa,2020-12-27,32,1850,16,1627,16,223,0,0,32,1851,0,0,32,1851,California
Napa,2020-12-28,248,2098,184,1811,64,287,0,0,276,2127,0,0,276,2127,California
Napa,2020-12-29,271,2369,213,2024,58,345,0,0,305,2432,0,0,305,2432,California
Napa,2020-12-30,634,3003,490,2514,144,489,0,0,642,3074,0,0,642,3074,California
Napa,2020-12-31,466,3469,378,2892,88,577,0,0,466,3540,0,0,466,3540,California
Napa,2021-01-01,1,3470,1,2893,0,577,0,0,1,3541,0,0,1,3541,California
Napa,2021-01-02,99,3569,95,2988,4,581,0,0,99,3640,0,0,99,3640,California
Napa,2021-01-03,12,3581,10,2998,2,583,0,0,9,3649,0,0,9,3649,California
Napa,2021-01-04,105,3686,62,3060,43,626,0,0,105,3754,0,0,105,3754,California
Napa,2021-01-05,152,3838,85,3145,67,693,0,0,135,3865,24,24,135,3889,California
Napa,2021-01-06,455,4293,114,3259,341,1034,0,0,391,4194,62,86,391,4280,California
Napa,2021-01-07,484,4777,223,3482,261,1295,0,0,384,4479,99,185,384,4664,California
Napa,2021-01-08,441,5218,226,3708,215,1510,0,0,263,4564,178,363,263,4927,California
Napa,2021-01-09,305,5523,279,3987,26,1536,0,0,167,4593,138,501,167,5094,California
Napa,2021-01-10,184,5707,101,4088,83,1619,0,0,109,4627,75,576,109,5203,California
Napa,2021-01-11,875,6582,417,4505,458,2077,0,0,508,4767,368,944,508,5711,California
Napa,2021-01-12,1301,7883,371,4876,930,3007,0,0,987,5440,314,1258,987,6698,California
Napa,2021-01-13,1296,9179,260,5136,1036,4043,0,0,1137,6420,158,1416,1138,7836,California
Napa,2021-01-14,1046,10225,174,5310,872,4915,0,0,928,7232,116,1532,928,8764,California
Napa,2021-01-15,1445,11670,380,5690,1065,5980,0,0,1296,8371,158,1690,1297,10061,California
Napa,2021-01-16,352,12022,137,5827,215,6195,0,0,334,8687,18,1708,334,10395,California
Napa,2021-01-17,337,12359,176,6003,161,6356,0,0,328,9006,9,1717,328,10723,California
Napa,2021-01-18,1073,13432,194,6197,879,7235,0,0,981,9895,92,1809,981,11704,California
Napa,2021-01-19,999,14431,401,6598,598,7833,0,0,760,10417,238,2047,760,12464,California
Napa,2021-01-20,819,15250,183,6781,636,8469,0,0,639,10878,178,2225,639,13103,California
Napa,2021-01-21,1329,16579,379,7160,950,9419,0,0,1071,11692,257,2482,1071,14174,California
Napa,2021-01-22,1497,18076,416,7576,1081,10500,0,0,1165,12527,331,2813,1166,15340,California
Napa,2021-01-23,396,18472,315,7891,81,10581,0,0,335,12801,61,2874,335,15675,California
Napa,2021-01-24,275,18747,199,8090,76,10657,0,0,217,12960,58,2932,217,15892,California
Napa,2021-01-25,1515,20262,229,8319,1286,11943,0,0,1427,14299,88,3020,1427,17319,California
Napa,2021-01-26,866,21128,278,8597,588,12531,0,0,773,14980,93,3113,774,18093,California
Napa,2021-01-27,620,21748,219,8816,401,12932,0,0,468,15297,151,3264,468,18561,California
Napa,2021-01-28,370,22118,163,8979,207,13139,0,0,194,15316,175,3439,194,18755,California
Napa,2021-01-29,246,22364,62,9041,184,13323,0,0,153,15376,93,3532,153,18908,California
Napa,2021-01-30,785,23149,676,9717,109,13432,0,0,644,15879,141,3673,644,19552,California
Napa,2021-01-31,649,23798,620,10337,29,13461,0,0,624,16478,25,3698,624,20176,California
Napa,2021-02-01,311,24109,109,10446,202,13663,0,0,160,16488,150,3848,160,20336,California
Napa,2021-02-02,571,24680,274,10720,297,13960,0,0,281,16480,289,4137,281,20617,California
Napa,2021-02-03,726,25406,309,11029,417,14377,0,0,422,16598,304,4441,422,21039,California
Napa,2021-02-04,784,26190,370,11399,414,14791,0,0,439,16695,342,4783,439,21478,California
Napa,2021-02-05,704,26894,314,11713,390,15181,0,0,338,16668,366,5149,339,21817,California
Napa,2021-02-06,427,27321,141,11854,286,15467,0,0,323,16887,104,5253,323,22140,California
Napa,2021-02-07,178,27499,165,12019,13,15480,0,0,75,16859,103,5356,75,22215,California
Napa,2021-02-08,829,28328,185,12204,644,16124,0,0,264,16561,563,5919,265,22480,California
Napa,2021-02-09,1071,29399,437,12641,634,16758,0,0,433,16356,638,6557,433,22913,California
Napa,2021-02-10,1652,31051,189,12830,1463,18221,0,0,443,15593,1206,7763,443,23356,California
Napa,2021-02-11,1481,32532,192,13022,1289,19510,0,0,410,14941,1062,8825,410,23766,California
Napa,2021-02-12,2146,34678,838,13860,1308,20818,0,0,714,14226,1429,10254,714,24480,California
Napa,2021-02-13,488,35166,49,13909,439,21257,0,0,310,14358,178,10432,310,24790,California
Napa,2021-02-14,321,35487,57,13966,264,21521,0,0,162,14361,159,10591,162,24952,California
Napa,2021-02-15,839,36326,147,14113,692,22213,0,0,219,13963,617,11208,219,25171,California
Napa,2021-02-16,1206,37532,529,14642,677,22890,0,0,589,13936,616,11824,589,25760,California
Napa,2021-02-17,992,38524,498,15140,494,23384,0,0,443,13832,548,12372,444,26204,California
Napa,2021-02-18,1833,40357,475,15615,1358,24742,0,0,654,13309,1177,13549,654,26858,California
Napa,2021-02-19,1207,41564,568,16183,639,25381,0,0,643,13390,564,14113,645,27503,California
Napa,2021-02-20,786,42350,574,16757,212,25593,0,0,262,13128,524,14637,262,27765,California
Napa,2021-02-21,722,43072,666,17423,56,25649,0,0,176,12758,546,15183,176,27941,California
Napa,2021-02-22,414,43486,177,17600,237,25886,0,0,132,12610,282,15465,134,28075,California
Napa,2021-02-23,1038,44524,270,17870,768,26654,0,0,283,12138,755,16220,283,28358,California
Napa,2021-02-24,1063,45587,545,18415,518,27172,0,0,532,12141,529,16749,532,28890,California
Napa,2021-02-25,2343,47930,1139,19554,1204,28376,0,0,1672,13145,669,17418,1673,30563,California
Napa,2021-02-26,1399,49329,488,20042,911,29287,0,0,535,12818,862,18280,535,31098,California
Napa,2021-02-27,1028,50357,344,20386,684,29971,0,0,788,13369,237,18517,788,31886,California
Napa,2021-02-28,548,50905,454,20840,94,30065,0,0,446,13716,99,18616,446,32332,California
Napa,2021-03-01,1054,51959,784,21624,270,30335,0,0,798,14259,255,18871,798,33130,California
Napa,2021-03-02,1420,53379,1001,22625,419,30754,0,0,1106,15052,313,19184,1106,34236,California
Napa,2021-03-03,1223,54602,605,23230,618,31372,0,0,1061,15953,161,19345,1062,35298,California
Napa,2021-03-04,1277,55879,415,23645,862,32234,0,0,1072,16822,204,19549,1073,36371,California
Napa,2021-03-05,1595,57474,550,24195,1042,33276,3,3,1212,17658,381,19930,1217,37588,California
Napa,2021-03-06,582,58056,252,24447,301,33577,29,32,480,18066,101,20031,509,38097,California
Napa,2021-03-07,462,58518,274,24721,174,33751,14,46,359,18337,102,20133,373,38470,California
Napa,2021-03-08,624,59142,300,25021,294,34045,30,76,477,18699,145,20278,507,38977,California
Napa,2021-03-09,1313,60455,565,25586,708,34753,40,116,947,19324,363,20641,988,39965,California
Napa,2021-03-10,1304,61759,777,26363,431,35184,96,212,622,19363,679,21320,718,40683,California
Napa,2021-03-11,1709,63468,1034,27397,565,35749,110,322,839,19443,869,22189,949,41632,California
Napa,2021-03-12,1358,64826,844,28241,434,36183,80,402,742,19653,615,22804,825,42457,California
Napa,2021-03-13,960,65786,278,28519,661,36844,21,423,751,20217,209,23013,773,43230,California
Napa,2021-03-14,499,66285,270,28789,89,36933,140,563,197,20252,302,23315,337,43567,California
Napa,2021-03-15,906,67191,380,29169,458,37391,68,631,464,20343,441,23756,532,44099,California
Napa,2021-03-16,1210,68401,386,29555,699,38090,125,756,776,20812,432,24188,901,45000,California
Napa,2021-03-17,1667,70068,1266,30821,295,38385,106,862,1037,21325,630,24818,1143,46143,California
Napa,2021-03-18,866,70934,479,31300,383,38768,4,866,425,21314,440,25258,429,46572,California
Napa,2021-03-19,425,71359,329,31629,92,38860,4,870,163,21220,261,25519,167,46739,California
Santa Clara,2020-12-15,63,63,63,63,0,0,0,0,63,63,0,0,63,63,California
Santa Clara,2020-12-16,128,191,128,191,0,0,0,0,128,191,0,0,128,191,California
Santa Clara,2020-12-17,451,642,451,642,0,0,0,0,451,642,0,0,451,642,California
Santa Clara,2020-12-18,1717,2359,1717,2359,0,0,0,0,1717,2359,0,0,1717,2359,California
Santa Clara,2020-12-19,2109,4468,2109,4468,0,0,0,0,2107,4465,1,1,2107,4466,California
Santa Clara,2020-12-20,1872,6340,1866,6334,6,6,0,0,1869,6334,0,1,1869,6335,California
Santa Clara,2020-12-21,2640,8980,2640,8974,0,6,0,0,2637,8970,1,2,2637,8972,California
Santa Clara,2020-12-22,3097,12077,3088,12062,9,15,0,0,3095,12065,0,2,3095,12067,California
Santa Clara,2020-12-23,3230,15307,3045,15107,185,200,0,0,3228,15293,0,2,3228,15295,California
Santa Clara,2020-12-24,1886,17193,1697,16804,189,389,0,0,1880,17172,1,3,1880,17175,California
Santa Clara,2020-12-25,337,17530,336,17140,1,390,0,0,337,17509,0,3,337,17512,California
Santa Clara,2020-12-26,1255,18785,1024,18164,231,621,0,0,1254,18763,0,3,1254,18766,California
Santa Clara,2020-12-27,634,19419,497,18661,137,758,0,0,634,19397,0,3,634,19400,California
Santa Clara,2020-12-28,2318,21737,1716,20377,602,1360,0,0,2318,21715,0,3,2318,21718,California
Santa Clara,2020-12-29,2317,24054,1455,21832,862,2222,0,0,2315,24030,0,3,2315,24033,California
Santa Clara,2020-12-30,2963,27017,1879,23711,1084,3306,0,0,2963,26993,0,3,2963,26996,California
Santa Clara,2020-12-31,1201,28218,385,24096,816,4122,0,0,1200,28192,1,4,1200,28196,California
Santa Clara,2021-01-01,131,28349,5,24101,126,4248,0,0,131,28323,0,4,131,28327,California
Santa Clara,2021-01-02,1076,29425,810,24911,266,4514,0,0,1076,29399,0,4,1076,29403,California
Santa Clara,2021-01-03,581,30006,365,25276,216,4730,0,0,579,29976,2,6,579,29982,California
Santa Clara,2021-01-04,2469,32475,1666,26942,803,5533,0,0,2466,32441,1,7,2466,32448,California
Santa Clara,2021-01-05,3047,35522,1992,28934,1055,6588,0,0,2862,35122,184,191,2865,35313,California
Santa Clara,2021-01-06,3293,38815,1937,30871,1356,7944,0,0,2729,37290,561,752,2729,38042,California
Santa Clara,2021-01-07,4106,42921,2460,33331,1646,9590,0,0,3083,39366,1013,1765,3089,41131,California
Santa Clara,2021-01-08,5841,48762,3821,37152,2020,11610,0,0,3784,41098,2052,3817,3784,44915,California
Santa Clara,2021-01-09,2972,51734,1867,39019,1105,12715,0,0,1705,41538,1267,5084,1707,46622,California
Santa Clara,2021-01-10,1863,53597,1422,40441,441,13156,0,0,725,41126,1137,6221,725,47347,California
Santa Clara,2021-01-11,5585,59182,3398,43839,2187,15343,0,0,3272,42089,2313,8534,3276,50623,California
Santa Clara,2021-01-12,6641,65823,3263,47102,3378,18721,0,0,4475,44400,2166,10700,4477,55100,California
Santa Clara,2021-01-13,7375,73198,3047,50149,4328,23049,0,0,5213,47460,2159,12859,5219,60319,California
Santa Clara,2021-01-14,8122,81320,2693,52842,5429,28478,0,0,6472,52289,1647,14506,6476,66795,California
Santa Clara,2021-01-15,9524,90844,2906,55748,6618,35096,0,0,8083,58938,1437,15943,8086,74881,California
Santa Clara,2021-01-16,4430,95274,1301,57049,3129,38225,0,0,3536,61583,891,16834,3536,78417,California
Santa Clara,2021-01-17,3230,98504,611,57660,2619,40844,0,0,2728,63811,500,17334,2728,81145,California
Santa Clara,2021-01-18,5200,103704,1249,58909,3951,44795,0,0,4555,67723,645,17979,4557,85702,California
Santa Clara,2021-01-19,8354,112058,2606,61515,5748,50543,0,0,6716,72807,1636,19615,6720,92422,California
Santa Clara,2021-01-20,7877,119935,3938,65453,3939,54482,0,0,6361,77655,1513,21128,6361,98783,California
Santa Clara,2021-01-21,8447,128382,3613,69066,4834,59316,0,0,7307,83826,1137,22265,7308,106091,California
Santa Clara,2021-01-22,8648,137030,3263,72329,5385,64701,0,0,8004,91190,642,22907,8006,114097,California
Santa Clara,2021-01-23,3774,140804,1678,74007,2096,66797,0,0,2819,93054,955,23862,2819,116916,California
Santa Clara,2021-01-24,2888,143692,1473,75480,1415,68212,0,0,2354,94876,533,24395,2355,119271,California
Santa Clara,2021-01-25,8289,151981,3721,79201,4568,72780,0,0,6286,99179,1996,26391,6299,125570,California
Santa Clara,2021-01-26,8145,160126,3751,82952,4394,77174,0,0,6011,103070,2123,28514,6014,131584,California
Santa Clara,2021-01-27,8530,168656,3748,86700,4782,81956,0,0,6677,107913,1835,30349,6678,138262,California
Santa Clara,2021-01-28,9320,177976,3741,90441,5579,87535,0,0,7371,113363,1925,32274,7375,145637,California
Santa Clara,2021-01-29,9403,187379,3862,94303,5541,93076,0,0,7296,118562,2097,34371,7296,152933,California
Santa Clara,2021-01-30,3786,191165,1687,95990,2099,95175,0,0,2897,120573,887,35258,2898,155831,California
Santa Clara,2021-01-31,2563,193728,1694,97684,869,96044,0,0,1576,121170,980,36238,1577,157408,California
Santa Clara,2021-02-01,7763,201491,3442,101126,4321,100365,0,0,6096,125609,1661,37899,6100,163508,California
Santa Clara,2021-02-02,7945,209436,2841,103967,5104,105469,0,0,5973,129618,1968,39867,5977,169485,California
Santa Clara,2021-02-03,9112,218548,3457,107424,5655,111124,0,0,6865,134246,2242,42109,6870,176355,California
Santa Clara,2021-02-04,10454,229002,4094,111518,6360,117484,0,0,8227,140256,2220,44329,8230,184585,California
Santa Clara,2021-02-05,11785,240787,4306,115824,7479,124963,0,0,8360,145207,3410,47739,8361,192946,California
Santa Clara,2021-02-06,5086,245873,2774,118598,2312,127275,0,0,3979,148082,1104,48843,3979,196925,California
Santa Clara,2021-02-07,3461,249334,2339,120937,1122,128397,0,0,3018,150659,441,49284,3018,199943,California
Santa Clara,2021-02-08,9454,258788,3443,124380,6011,134408,0,0,6817,154856,2622,51906,6819,206762,California
Santa Clara,2021-02-09,10444,269232,3761,128141,6683,141091,0,0,7043,158507,3393,55299,7044,213806,California
Santa Clara,2021-02-10,12543,281775,4837,132978,7706,148797,0,0,6893,159765,5639,60938,6897,220703,California
Santa Clara,2021-02-11,12183,293958,4243,137221,7940,156737,0,0,6998,161589,5174,66112,6998,227701,California
Santa Clara,2021-02-12,13985,307943,4389,141610,9596,166333,0,0,6688,160998,7281,73393,6690,234391,California
Santa Clara,2021-02-13,6027,313970,1433,143043,4594,170927,0,0,2198,159370,3826,77219,2198,236589,California
Santa Clara,2021-02-14,4619,318589,1140,144183,3479,174406,0,0,1487,157726,3131,80350,1487,238076,California
Santa Clara,2021-02-15,6182,324771,2743,146926,3439,177845,0,0,2657,156869,3520,83870,2663,240739,California
Santa Clara,2021-02-16,13201,337972,3892,150818,9309,187154,0,0,6531,156749,6653,90523,6533,247272,California
Santa Clara,2021-02-17,12984,350956,5311,156129,7673,194827,0,0,6459,156702,6511,97034,6464,253736,California
Santa Clara,2021-02-18,12591,363547,7756,163885,4835,199662,0,0,6353,156840,6221,103255,6359,260095,California
Santa Clara,2021-02-19,13973,377520,9144,173029,4829,204491,0,0,8160,159214,5796,109051,8170,268265,California
Santa Clara,2021-02-20,6586,384106,4908,177937,1678,206169,0,0,3630,159899,2946,111997,3631,271896,California
Santa Clara,2021-02-21,3052,387158,2267,180204,785,206954,0,0,1105,159062,1942,113939,1105,273001,California
Santa Clara,2021-02-22,9441,396599,5608,185812,3833,210787,0,0,4529,158689,4903,118842,4530,277531,California
Santa Clara,2021-02-23,10969,407568,7128,192940,3841,214628,0,0,6362,160463,4601,123443,6375,283906,California
Santa Clara,2021-02-24,12546,420114,8008,200948,4538,219166,0,0,7703,163341,4829,128272,7707,291613,California
Santa Clara,2021-02-25,13158,433272,8675,209623,4483,223649,0,0,7207,164615,5936,134208,7210,298823,California
Santa Clara,2021-02-26,11963,445235,6626,216249,5337,228986,0,0,6148,164980,5791,139999,6156,304979,California
Santa Clara,2021-02-27,7909,453144,5406,221655,2503,231489,0,0,4371,165826,3530,143529,4376,309355,California
Santa Clara,2021-02-28,4575,457719,3024,224679,1551,233040,0,0,2100,165458,2468,145997,2100,311455,California
Santa Clara,2021-03-01,13187,470906,7442,232121,5745,238785,0,0,8274,168843,4898,150895,8283,319738,California
Santa Clara,2021-03-02,12115,483021,7361,239482,4754,243539,0,0,8176,173100,3923,154818,8180,327918,California
Santa Clara,2021-03-03,16178,499199,7826,247308,8351,251890,1,1,9910,176780,6232,161050,9912,337830,California
Santa Clara,2021-03-04,13360,512559,7515,254823,5845,257735,0,1,7568,178587,5765,166815,7572,345402,California
Santa Clara,2021-03-05,13664,526223,8030,262853,5511,263246,123,124,7395,179867,6253,173068,7533,352935,California
Santa Clara,2021-03-06,8765,534988,5867,268720,2452,265698,446,570,6581,184725,2173,175241,7031,359966,California
Santa Clara,2021-03-07,6394,541382,4144,272864,2035,267733,215,785,5120,188794,1269,176510,5338,365304,California
Santa Clara,2021-03-08,11970,553352,6331,279195,5259,272992,380,1165,7870,192959,4087,180597,8252,373556,California
Santa Clara,2021-03-09,11725,565077,5148,284343,5469,278461,1108,2273,5728,193810,5986,186583,6837,380393,California
Santa Clara,2021-03-10,13870,578947,6137,290480,6220,284681,1513,3786,5788,193053,8061,194644,7304,387697,California
Santa Clara,2021-03-11,15371,594318,7184,297664,6987,291668,1200,4986,5751,190411,9604,204248,6962,394659,California
Santa Clara,2021-03-12,15005,609323,7913,305577,6179,297847,913,5899,5651,187661,9328,213576,6578,401237,California
Santa Clara,2021-03-13,9063,618386,5406,310983,2555,300402,1102,7001,4147,188013,4898,218474,5250,406487,California
Santa Clara,2021-03-14,5938,624324,3218,314201,1565,301967,1155,8156,3032,189304,2897,221371,4188,410675,California
Santa Clara,2021-03-15,12560,636884,6302,320503,5993,307960,265,8421,6108,189252,6429,227800,6377,417052,California
Santa Clara,2021-03-16,16909,653793,9990,330493,6716,314676,203,8624,8510,189595,8373,236173,8716,425768,California
Santa Clara,2021-03-17,16403,670196,9026,339519,7231,321907,146,8770,8920,191218,7446,243619,9069,434837,California
Santa Clara,2021-03-18,9533,679729,4730,344249,4198,326105,605,9375,4336,190994,5172,248791,4948,439785,California
Santa Clara,2021-03-19,7528,687257,3833,348082,3261,329366,434,9809,3878,191681,3629,252420,4316,444101,California
San Mateo,2020-12-15,25,25,25,25,0,0,0,0,25,25,0,0,25,25,California
San Mateo,2020-12-16,103,128,103,128,0,0,0,0,103,128,0,0,103,128,California
San Mateo,2020-12-17,177,305,177,305,0,0,0,0,177,305,0,0,177,305,California
San Mateo,2020-12-18,768,1073,766,1071,2,2,0,0,767,1071,1,1,767,1072,California
San Mateo,2020-12-19,523,1596,523,1594,0,2,0,0,523,1594,0,1,523,1595,California
San Mateo,2020-12-20,512,2108,511,2105,1,3,0,0,512,2106,0,1,512,2107,California
San Mateo,2020-12-21,1155,3263,1155,3260,0,3,0,0,1155,3261,0,1,1155,3262,California
San Mateo,2020-12-22,1505,4768,1498,4758,7,10,0,0,1505,4766,0,1,1505,4767,California
San Mateo,2020-12-23,1557,6325,1372,6130,185,195,0,0,1557,6323,0,1,1557,6324,California
San Mateo,2020-12-24,857,7182,602,6732,255,450,0,0,857,7180,0,1,857,7181,California
San Mateo,2020-12-25,112,7294,108,6840,4,454,0,0,112,7292,0,1,112,7293,California
San Mateo,2020-12-26,553,7847,410,7250,143,597,0,0,553,7845,0,1,553,7846,California
San Mateo,2020-12-27,297,8144,168,7418,129,726,0,0,297,8142,0,1,297,8143,California
San Mateo,2020-12-28,1035,9179,689,8107,346,1072,0,0,1035,9177,0,1,1035,9178,California
San Mateo,2020-12-29,1118,10297,702,8809,416,1488,0,0,1118,10295,0,1,1118,10296,California
San Mateo,2020-12-30,1257,11554,757,9566,500,1988,0,0,1257,11552,0,1,1257,11553,California
San Mateo,2020-12-31,703,12257,221,9787,482,2470,0,0,702,12253,1,2,702,12255,California
San Mateo,2021-01-01,34,12291,29,9816,5,2475,0,0,34,12287,0,2,34,12289,California
San Mateo,2021-01-02,395,12686,266,10082,129,2604,0,0,395,12682,0,2,395,12684,California
San Mateo,2021-01-03,281,12967,207,10289,74,2678,0,0,277,12955,4,6,277,12961,California
San Mateo,2021-01-04,1044,14011,673,10962,371,3049,0,0,1043,13997,1,7,1043,14004,California
San Mateo,2021-01-05,1179,15190,692,11654,487,3536,0,0,1151,15121,28,35,1152,15156,California
San Mateo,2021-01-06,1436,16626,945,12599,491,4027,0,0,1256,16200,177,212,1256,16412,California
San Mateo,2021-01-07,1408,18034,765,13364,643,4670,0,0,1135,17070,266,478,1136,17548,California
San Mateo,2021-01-08,1814,19848,1170,14534,644,5314,0,0,1129,17519,681,1159,1130,18678,California
San Mateo,2021-01-09,1189,21037,788,15322,401,5715,0,0,740,17810,449,1608,740,19418,California
San Mateo,2021-01-10,679,21716,551,15873,128,5843,0,0,256,17643,423,2031,256,19674,California
San Mateo,2021-01-11,2410,24126,1305,17178,1105,6948,0,0,1502,18238,909,2940,1504,21178,California
San Mateo,2021-01-12,3267,27393,1758,18936,1509,8457,0,0,2089,19150,1178,4118,2090,23268,California
San Mateo,2021-01-13,3448,30841,1738,20674,1710,10167,0,0,2426,20556,1022,5140,2428,25696,California
San Mateo,2021-01-14,3756,34597,1563,22237,2193,12360,0,0,3085,22975,670,5810,3089,28785,California
San Mateo,2021-01-15,4356,38953,1797,24034,2559,14919,0,0,3778,26180,576,6386,3781,32566,California
San Mateo,2021-01-16,3125,42078,816,24850,2309,17228,0,0,2771,28598,354,6740,2772,35338,California
San Mateo,2021-01-17,1311,43389,307,25157,1004,18232,0,0,1107,29501,204,6944,1107,36445,California
San Mateo,2021-01-18,1392,44781,554,25711,838,19070,0,0,989,30095,401,7345,995,37440,California
San Mateo,2021-01-19,2772,47553,1758,27469,1014,20084,0,0,2001,31327,770,8115,2002,39442,California
San Mateo,2021-01-20,2627,50180,1382,28851,1245,21329,0,0,1793,32291,830,8945,1794,41236,California
San Mateo,2021-01-21,2795,52975,1277,30128,1518,22847,0,0,2220,33940,574,9519,2223,43459,California
San Mateo,2021-01-22,2837,55812,1178,31306,1659,24506,0,0,2492,36089,343,9862,2492,45951,California
San Mateo,2021-01-23,2879,58691,1684,32990,1195,25701,0,0,2519,38250,359,10221,2520,48471,California
San Mateo,2021-01-24,1578,60269,394,33384,1184,26885,0,0,1250,39175,325,10546,1250,49721,California
San Mateo,2021-01-25,4379,64648,3108,36492,1271,28156,0,0,3524,41849,852,11398,3526,53247,California
San Mateo,2021-01-26,4276,68924,2977,39469,1299,29455,0,0,3363,44300,912,12310,3363,56610,California
San Mateo,2021-01-27,2741,71665,1429,40898,1312,30767,0,0,1776,45116,961,13271,1777,58387,California
San Mateo,2021-01-28,2760,74425,1338,42236,1422,32189,0,0,1912,46199,829,14100,1912,60299,California
San Mateo,2021-01-29,2882,77307,1259,43495,1623,33812,0,0,2118,47556,761,14861,2118,62417,California
San Mateo,2021-01-30,3224,80531,1331,44826,1893,35705,0,0,2909,50153,313,15174,2910,65327,California
San Mateo,2021-01-31,1903,82434,1120,45946,783,36488,0,0,1515,51285,383,15557,1515,66842,California
San Mateo,2021-02-01,2904,85338,1326,47272,1578,38066,0,0,2207,52799,694,16251,2208,69050,California
San Mateo,2021-02-02,3127,88465,1720,48992,1407,39473,0,0,2129,53931,997,17248,2129,71179,California
San Mateo,2021-02-03,4851,93316,1926,50918,2925,42398,0,0,3809,56702,1039,18287,3810,74989,California
San Mateo,2021-02-04,6251,99567,2570,53488,3681,46079,0,0,4904,60266,1341,19628,4905,79894,California
San Mateo,2021-02-05,6753,106320,2538,56026,4215,50294,0,0,4940,63413,1794,21422,4941,84835,California
San Mateo,2021-02-06,3271,109591,1910,57936,1361,51655,0,0,2622,65387,649,22071,2623,87458,California
San Mateo,2021-02-07,1889,111480,1326,59262,563,52218,0,0,1704,66906,185,22256,1704,89162,California
San Mateo,2021-02-08,5212,116692,2205,61467,3007,55225,0,0,3045,67848,2104,24360,3046,92208,California
San Mateo,2021-02-09,6113,122805,3176,64643,2937,58162,0,0,3289,68318,2820,27180,3290,95498,California
San Mateo,2021-02-10,6479,129284,3266,67909,3213,61375,0,0,3542,68931,2929,30109,3542,99040,California
San Mateo,2021-02-11,6806,136090,3427,71336,3379,64754,0,0,3657,69446,3142,33251,3657,102697,California
San Mateo,2021-02-12,6492,142582,2921,74257,3571,68325,0,0,4618,72195,1871,35122,4620,107317,California
San Mateo,2021-02-13,5989,148571,3931,78188,2058,70383,0,0,2576,71359,3412,38534,2576,109893,California
San Mateo,2021-02-14,4608,153179,3003,81191,1605,71988,0,0,1965,70684,2641,41175,1966,111859,California
San Mateo,2021-02-15,3125,156304,1436,82627,1689,73677,0,0,1761,71086,1361,42536,1763,113622,California
San Mateo,2021-02-16,6987,163291,1789,84416,5198,78875,0,0,5165,74430,1821,44357,5165,118787,California
San Mateo,2021-02-17,6723,170014,1725,86141,4998,83873,0,0,4835,77385,1882,46239,4837,123624,California
San Mateo,2021-02-18,6282,176296,4318,90459,1964,85837,0,0,4121,79349,2157,48396,4121,127745,California
San Mateo,2021-02-19,7445,183741,5378,95837,2067,87904,0,0,5588,83082,1855,50251,5588,133333,California
San Mateo,2021-02-20,3578,187319,2310,98147,1268,89172,0,0,2242,83993,1331,51582,2242,135575,California
San Mateo,2021-02-21,2086,189405,1306,99453,780,89952,0,0,1174,84257,910,52492,1174,136749,California
San Mateo,2021-02-22,4188,193593,3020,102473,1168,91120,0,0,2638,85353,1544,54036,2640,139389,California
San Mateo,2021-02-23,4052,197645,2881,105354,1171,92291,0,0,2315,85935,1735,55771,2317,141706,California
San Mateo,2021-02-24,7018,204663,3141,108495,3877,96168,0,0,4673,88269,2339,58110,4673,146379,California
San Mateo,2021-02-25,8621,213284,3878,112373,4743,100911,0,0,5672,91003,2940,61050,5674,152053,California
San Mateo,2021-02-26,8884,222168,3488,115861,5396,106307,0,0,6153,94432,2724,63774,6153,158206,California
San Mateo,2021-02-27,6478,228646,3345,119206,3133,109440,0,0,3470,94903,3004,66778,3475,161681,California
San Mateo,2021-02-28,3994,232640,2440,121646,1554,110994,0,0,2460,95833,1532,68310,2462,164143,California
San Mateo,2021-03-01,5318,237958,3415,125061,1903,112897,0,0,2664,95848,2649,70959,2664,166807,California
San Mateo,2021-03-02,5203,243161,3672,128733,1531,114428,0,0,3035,96724,2160,73119,3036,169843,California
San Mateo,2021-03-03,7473,250634,3506,132239,3967,118395,0,0,3074,95408,4392,77511,3076,172919,California
San Mateo,2021-03-04,7202,257836,3511,135750,3690,122085,1,1,3130,94483,4062,81573,3137,176056,California
San Mateo,2021-03-05,7996,265832,5531,141281,2463,124548,2,3,5809,98127,2173,83746,5817,181873,California
San Mateo,2021-03-06,7523,273355,5275,146556,2086,126634,162,165,5571,101915,1946,85692,5734,187607,California
San Mateo,2021-03-07,3411,276766,2274,148830,1065,127699,72,237,1957,102492,1452,87144,2029,189636,California
San Mateo,2021-03-08,3949,280715,2315,151145,1506,129205,128,365,2905,104490,1039,88183,3037,192673,California
San Mateo,2021-03-09,4390,285105,2037,153182,2074,131279,279,644,2895,106177,1487,89670,3174,195847,California
San Mateo,2021-03-10,5103,290208,2541,155723,2294,133573,268,912,2876,107105,2219,91889,3147,198994,California
San Mateo,2021-03-11,7253,297461,4083,159806,2841,136414,329,1241,3562,107316,3684,95573,3895,202889,California
San Mateo,2021-03-12,8012,305473,4572,164378,3179,139593,261,1502,3386,106353,4614,100187,3651,206540,California
San Mateo,2021-03-13,5904,311377,3143,167521,2577,142170,184,1686,3636,107906,2268,102455,3821,210361,California
San Mateo,2021-03-14,4628,316005,3225,170746,1307,143477,96,1782,2892,109160,1734,104189,2988,213349,California
San Mateo,2021-03-15,6937,322942,4444,175190,2328,145805,165,1947,3859,110116,3071,107260,4027,217376,California
San Mateo,2021-03-16,9842,332784,4334,179524,5378,151183,130,2077,4752,109919,5083,112343,4886,222262,California
San Mateo,2021-03-17,7931,340715,3574,183098,4252,155435,105,2182,4288,110686,3631,115974,4398,226660,California
San Mateo,2021-03-18,4063,344778,2543,185641,1464,156899,56,2238,2263,111210,1798,117772,2322,228982,California
San Mateo,2021-03-19,2855,347633,1753,187394,796,157695,306,2544,1259,111182,1595,119367,1567,230549,California
Outside California,2020-12-15,7,7,7,7,0,0,0,0,7,7,0,0,7,7,Not in California
Outside California,2020-12-16,131,138,131,138,0,0,0,0,131,138,0,0,131,138,Not in California
Outside California,2020-12-17,1530,1668,1530,1668,0,0,0,0,1530,1668,0,0,1530,1668,Not in California
Outside California,2020-12-18,2395,4063,2391,4059,4,4,0,0,2394,4062,0,0,2394,4062,Not in California
Outside California,2020-12-19,1004,5067,1003,5062,1,5,0,0,1004,5066,0,0,1004,5066,Not in California
Outside California,2020-12-20,650,5717,649,5711,1,6,0,0,650,5716,0,0,650,5716,Not in California
Outside California,2020-12-21,2093,7810,2093,7804,0,6,0,0,2092,7808,0,0,2092,7808,Not in California
Outside California,2020-12-22,1955,9765,1922,9726,33,39,0,0,1955,9763,0,0,1955,9763,Not in California
Outside California,2020-12-23,1417,11182,1305,11031,112,151,0,0,1417,11180,0,0,1417,11180,Not in California
Outside California,2020-12-24,807,11989,613,11644,194,345,0,0,807,11987,0,0,807,11987,Not in California
Outside California,2020-12-25,33,12022,29,11673,4,349,0,0,33,12020,0,0,33,12020,Not in California
Outside California,2020-12-26,309,12331,204,11877,105,454,0,0,309,12329,0,0,309,12329,Not in California
Outside California,2020-12-27,188,12519,72,11949,116,570,0,0,188,12517,0,0,188,12517,Not in California
Outside California,2020-12-28,1393,13912,881,12830,512,1082,0,0,1393,13910,0,0,1393,13910,Not in California
Outside California,2020-12-29,1462,15374,937,13767,525,1607,0,0,1462,15372,0,0,1462,15372,Not in California
Outside California,2020-12-30,1850,17224,1192,14959,658,2265,0,0,1851,17223,0,0,1851,17223,Not in California
Outside California,2020-12-31,1072,18296,589,15548,483,2748,0,0,1073,18296,0,0,1073,18296,Not in California
Outside California,2021-01-01,102,18398,17,15565,85,2833,0,0,102,18398,0,0,102,18398,Not in California
Outside California,2021-01-02,240,18638,135,15700,105,2938,0,0,239,18636,1,1,239,18637,Not in California
Outside California,2021-01-03,176,18814,97,15797,79,3017,0,0,176,18812,0,1,176,18813,Not in California
Outside California,2021-01-04,1127,19941,503,16300,624,3641,0,0,1121,19932,1,2,1121,19934,Not in California
Outside California,2021-01-05,1439,21380,758,17058,681,4322,0,0,1301,21097,136,138,1301,21235,Not in California
Outside California,2021-01-06,2556,23936,1527,18585,1029,5351,0,0,1885,22304,678,816,1885,23120,Not in California
Outside California,2021-01-07,4075,28011,2514,21099,1561,6912,0,0,2441,23123,1633,2449,2452,25572,Not in California
Outside California,2021-01-08,4284,32295,2707,23806,1577,8489,0,0,2540,23936,1734,4183,2547,28119,Not in California
Outside California,2021-01-09,1330,33625,538,24344,792,9281,0,0,1003,24616,325,4508,1005,29124,Not in California
Outside California,2021-01-10,293,33918,179,24523,114,9395,0,0,172,24667,121,4629,172,29296,Not in California
Outside California,2021-01-11,3249,37167,1955,26478,1294,10689,0,0,1932,25282,1318,5947,1933,31229,Not in California
Outside California,2021-01-12,3765,40932,2264,28742,1501,12190,0,0,2284,26090,1476,7423,2284,33513,Not in California
Outside California,2021-01-13,3498,44430,1744,30486,1754,13944,0,0,2377,27346,1126,8549,2382,35895,Not in California
Outside California,2021-01-14,3692,48122,1231,31717,2461,16405,0,0,3082,29823,608,9157,3085,38980,Not in California
Outside California,2021-01-15,4047,52169,925,32642,3122,19527,0,0,3606,32995,438,9595,3610,42590,Not in California
Outside California,2021-01-16,2428,54597,343,32985,2085,21612,0,0,2267,35104,158,9753,2267,44857,Not in California
Outside California,2021-01-17,458,55055,145,33130,313,21925,0,0,402,35451,55,9808,402,45259,Not in California
Outside California,2021-01-18,1060,56115,749,33879,311,22236,0,0,589,35571,470,10278,590,45849,Not in California
Outside California,2021-01-19,3993,60108,1280,35159,2713,24949,0,0,3149,37878,844,11122,3151,49000,Not in California
Outside California,2021-01-20,4314,64422,1341,36500,2973,27922,0,0,3451,40470,860,11982,3452,52452,Not in California
Outside California,2021-01-21,4030,68452,979,37479,3051,30973,0,0,3511,43480,504,12486,3514,55966,Not in California
Outside California,2021-01-22,4585,73037,1002,38481,3583,34556,0,0,4180,47264,398,12884,4182,60148,Not in California
Outside California,2021-01-23,2308,75345,329,38810,1979,36535,0,0,2138,49234,169,13053,2139,62287,Not in California
Outside California,2021-01-24,1093,76438,591,39401,502,37037,0,0,1006,50158,87,13140,1011,63298,Not in California
Outside California,2021-01-25,4880,81318,2239,41640,2641,39678,0,0,4050,53375,842,13982,4059,67357,Not in California
Outside California,2021-01-26,6724,88042,3601,45241,3123,42801,0,0,5926,58492,817,14799,5934,73291,Not in California
Outside California,2021-01-27,5419,93461,3237,48478,2182,44983,0,0,4882,62819,558,15357,4885,78176,Not in California
Outside California,2021-01-28,5553,99014,3301,51779,2252,47235,0,0,5129,67509,440,15797,5130,83306,Not in California
Outside California,2021-01-29,4749,103763,3065,54844,1684,48919,0,0,4049,70853,705,16502,4049,87355,Not in California
Outside California,2021-01-30,4430,108193,2687,57531,1743,50662,0,0,4216,74854,215,16717,4216,91571,Not in California
Outside California,2021-01-31,4083,112276,3589,61120,494,51156,0,0,4008,78791,74,16791,4011,95582,Not in California
Outside California,2021-02-01,6307,118583,3222,64342,3085,54241,0,0,5672,83832,634,17425,5675,101257,Not in California
Outside California,2021-02-02,7888,126471,3083,67425,4805,59046,0,0,7198,90351,682,18107,7201,108458,Not in California
Outside California,2021-02-03,8298,134769,2964,70389,5334,64380,0,0,7509,97082,778,18885,7509,115967,Not in California
Outside California,2021-02-04,7545,142314,2895,73284,4650,69030,0,0,6621,102796,912,19797,6626,122593,Not in California
Outside California,2021-02-05,6698,149012,2185,75469,4513,73543,0,0,5722,107540,979,20776,5723,128316,Not in California
Outside California,2021-02-06,4525,153537,2240,77709,2285,75828,0,0,4103,111232,413,21189,4105,132421,Not in California
Outside California,2021-02-07,2937,156474,2422,80131,515,76343,0,0,2863,114023,74,21263,2865,135286,Not in California
Outside California,2021-02-08,5873,162347,3767,83898,2106,78449,0,0,4826,117823,1030,22293,4830,140116,Not in California
Outside California,2021-02-09,5058,167405,2418,86316,2640,81089,0,0,3768,120332,1280,23573,3789,143905,Not in California
Outside California,2021-02-10,6012,173417,2260,88576,3752,84841,0,0,3688,121749,2318,25891,3735,147640,Not in California
Outside California,2021-02-11,4966,178383,2068,90644,2898,87739,0,0,3848,124494,1111,27002,3856,151496,Not in California
Outside California,2021-02-12,4622,183005,1592,92236,3030,90769,0,0,3018,125921,1596,28598,3023,154519,Not in California
Outside California,2021-02-13,2277,185282,640,92876,1637,92406,0,0,1825,127308,443,29041,1830,156349,Not in California
Outside California,2021-02-14,1639,186921,645,93521,994,93400,0,0,1188,128062,448,29489,1202,157551,Not in California
Outside California,2021-02-15,2679,189600,1738,95259,941,94341,0,0,1139,127698,1526,31015,1162,158713,Not in California
Outside California,2021-02-16,6558,196158,3162,98421,3396,97737,0,0,2482,126116,4069,35084,2487,161200,Not in California
Outside California,2021-02-17,5938,202096,3161,101582,2777,100514,0,0,1621,123431,4310,39394,1625,162825,Not in California
Outside California,2021-02-18,6205,208301,3716,105298,2489,103003,0,0,1585,120416,4607,44001,1592,164417,Not in California
Outside California,2021-02-19,5192,213493,3532,108830,1660,104663,0,0,1839,118918,3350,47351,1852,166269,Not in California
Outside California,2021-02-20,3372,216865,2943,111773,429,105092,0,0,1040,117634,2332,49683,1048,167317,Not in California
Outside California,2021-02-21,2276,219141,2069,113842,207,105299,0,0,607,116581,1665,51348,612,167929,Not in California
Outside California,2021-02-22,3525,222666,2657,116499,868,106167,0,0,1001,115075,2523,53871,1017,168946,Not in California
Outside California,2021-02-23,5993,228659,3354,119853,2639,108806,0,0,1560,112239,4427,58298,1591,170537,Not in California
Outside California,2021-02-24,6143,234802,3401,123254,2742,111548,0,0,1466,109047,4673,62971,1481,172018,Not in California
Outside California,2021-02-25,6534,241336,3308,126562,3226,114774,0,0,2041,106642,4461,67432,2056,174074,Not in California
Outside California,2021-02-26,6096,247432,3133,129695,2963,117737,0,0,2544,105732,3477,70909,2567,176641,Not in California
Outside California,2021-02-27,4739,252171,2478,132173,2260,119997,1,1,1292,103596,3436,74345,1300,177941,Not in California
Outside California,2021-02-28,3398,255569,2661,134834,737,120734,0,1,1048,102301,2349,76694,1054,178995,Not in California
Outside California,2021-03-01,5051,260620,3423,138257,1628,122362,0,1,1193,99652,3850,80544,1201,180196,Not in California
Outside California,2021-03-02,6481,267101,2374,140631,4107,126469,0,1,1717,96664,4757,85301,1769,181965,Not in California
Outside California,2021-03-03,7581,274682,2718,143349,4863,131332,0,1,1893,92910,5673,90974,1919,183884,Not in California
Outside California,2021-03-04,6324,281006,2457,145806,3866,135198,1,2,1852,90330,4452,95426,1872,185756,Not in California
Outside California,2021-03-05,4611,285617,2007,147813,2589,137787,15,17,2285,90336,2316,97742,2322,188078,Not in California
Outside California,2021-03-06,4239,289856,1825,149638,2281,140068,133,150,2009,90263,2225,99967,2152,190230,Not in California
Outside California,2021-03-07,1878,291734,1105,150743,724,140792,49,199,1029,90512,849,100816,1098,191328,Not in California
Outside California,2021-03-08,2429,294163,1419,152162,844,141636,166,365,1699,91683,701,101517,1872,193200,Not in California
Outside California,2021-03-09,3271,297434,1086,153248,1924,143560,261,626,1579,91838,1688,103205,1843,195043,Not in California
Outside California,2021-03-10,3790,301224,1617,154865,1840,145400,333,959,2139,92676,1641,104846,2479,197522,Not in California
Outside California,2021-03-11,5243,306467,2360,157225,2358,147758,525,1484,2605,93218,2638,107484,3180,200702,Not in California
Outside California,2021-03-12,4382,310849,2301,159526,1671,149429,410,1894,2384,94032,1993,109477,2807,203509,Not in California
Outside California,2021-03-13,2573,313422,1322,160848,866,150295,385,2279,1604,95068,963,110440,1999,205508,Not in California
Outside California,2021-03-14,1871,315293,986,161834,535,150830,350,2629,1128,95810,742,111182,1484,206992,Not in California
Outside California,2021-03-15,3671,318964,1644,163478,1623,152453,404,3033,2206,96977,1458,112640,2625,209617,Not in California
Outside California,2021-03-16,5916,324880,2740,166218,2861,155314,315,3348,3352,98100,2562,115202,3685,213302,Not in California
Outside California,2021-03-17,6185,331065,3315,169533,2587,157901,283,3631,3667,99569,2514,117716,3983,217285,Not in California
Outside California,2021-03-18,5221,336286,2859,172392,2041,159942,321,3952,3047,100813,2166,119882,3410,220695,Not in California
Outside California,2021-03-19,2363,338649,1358,173750,840,160782,165,4117,1225,101205,1135,121017,1527,222222,Not in California
Outside California,2021-03-20,2,338651,2,173752,0,160782,0,4117,2,101207,0,121017,2,222224,Not in California
San Diego,2020-12-15,119,119,119,119,0,0,0,0,119,119,0,0,119,119,California
San Diego,2020-12-16,1100,1219,1100,1219,0,0,0,0,1100,1219,0,0,1100,1219,California
San Diego,2020-12-17,2208,3427,2208,3427,0,0,0,0,2208,3427,0,0,2208,3427,California
San Diego,2020-12-18,3425,6852,3425,6852,0,0,0,0,3425,6852,0,0,3425,6852,California
San Diego,2020-12-19,2299,9151,2299,9151,0,0,0,0,2299,9151,0,0,2299,9151,California
San Diego,2020-12-20,1178,10329,1176,10327,2,2,0,0,1178,10329,0,0,1178,10329,California
San Diego,2020-12-21,3505,13834,3504,13831,1,3,0,0,3505,13834,0,0,3505,13834,California
San Diego,2020-12-22,3965,17799,3400,17231,565,568,0,0,3965,17799,0,0,3965,17799,California
San Diego,2020-12-23,2957,20756,1972,19203,985,1553,0,0,2957,20756,0,0,2957,20756,California
San Diego,2020-12-24,2716,23472,2205,21408,511,2064,0,0,2716,23472,0,0,2716,23472,California
San Diego,2020-12-25,868,24340,867,22275,1,2065,0,0,867,24338,1,1,867,24339,California
San Diego,2020-12-26,3246,27586,2134,24409,1112,3177,0,0,3245,27583,0,1,3245,27584,California
San Diego,2020-12-27,2467,30053,1610,26019,857,4034,0,0,2466,30049,0,1,2466,30050,California
San Diego,2020-12-28,5763,35816,4179,30198,1584,5618,0,0,5763,35812,0,1,5763,35813,California
San Diego,2020-12-29,5364,41180,2936,33134,2428,8046,0,0,5363,41175,0,1,5363,41176,California
San Diego,2020-12-30,5834,47014,3039,36173,2795,10841,0,0,5834,47009,0,1,5834,47010,California
San Diego,2020-12-31,2903,49917,983,37156,1920,12761,0,0,2902,49910,1,2,2902,49912,California
San Diego,2021-01-01,990,50907,438,37594,552,13313,0,0,989,50899,0,2,989,50901,California
San Diego,2021-01-02,3738,54645,1309,38903,2429,15742,0,0,3738,54637,0,2,3738,54639,California
San Diego,2021-01-03,848,55493,626,39529,222,15964,0,0,847,55484,0,2,847,55486,California
San Diego,2021-01-04,3647,59140,2033,41562,1614,17578,0,0,3639,59122,1,3,3639,59125,California
San Diego,2021-01-05,4137,63277,1953,43515,2184,19762,0,0,3659,62315,474,477,3667,62792,California
San Diego,2021-01-06,4796,68073,2191,45706,2605,22367,0,0,3639,64825,1134,1611,3644,66436,California
San Diego,2021-01-07,5319,73392,2811,48517,2508,24875,0,0,3249,66016,2063,3674,3254,69690,California
San Diego,2021-01-08,7554,80946,4844,53361,2710,27585,0,0,3843,66184,3695,7369,3863,73553,California
San Diego,2021-01-09,2913,83859,1548,54909,1365,28950,0,0,1744,66780,1158,8527,1754,75307,California
San Diego,2021-01-10,1841,85700,1285,56194,556,29506,0,0,747,66452,1082,9609,754,76061,California
San Diego,2021-01-11,10149,95849,5844,62038,4305,33811,0,0,6629,69582,3513,13122,6643,82704,California
San Diego,2021-01-12,11005,106854,5296,67334,5709,39520,0,0,7644,73987,3352,16474,7757,90461,California
San Diego,2021-01-13,11326,118180,5000,72334,6326,45846,0,0,8786,80267,2527,19001,8807,99268,California
San Diego,2021-01-14,12155,130335,4722,77056,7433,53279,0,0,10002,88149,2144,21145,10026,109294,California
San Diego,2021-01-15,14771,145106,5267,82323,9504,62783,0,0,12159,97743,2593,23738,12187,121481,California
San Diego,2021-01-16,10550,155656,3558,85881,6992,69775,0,0,9113,105448,1432,25170,9137,130618,California
San Diego,2021-01-17,8459,164115,2444,88325,6015,75790,0,0,7624,112253,835,26005,7640,138258,California
San Diego,2021-01-18,12244,176359,5868,94193,6376,82166,0,0,9443,118964,2761,28766,9472,147730,California
San Diego,2021-01-19,14497,190856,5762,99955,8735,90901,0,0,11390,127507,3092,31858,11635,159365,California
San Diego,2021-01-20,18075,208931,6316,106271,11759,102660,0,0,14800,139214,3256,35114,14963,174328,California
San Diego,2021-01-21,17203,226134,5868,112139,11335,113995,0,0,15824,153804,1368,36482,15958,190286,California
San Diego,2021-01-22,17361,243495,4713,116852,12648,126643,0,0,15333,167197,2014,38496,15407,205693,California
San Diego,2021-01-23,14108,257603,5173,122025,8935,135578,0,0,11777,176690,2318,40814,11811,217504,California
San Diego,2021-01-24,11144,268747,2916,124941,8228,143806,0,0,10216,186026,928,41742,10264,227768,California
San Diego,2021-01-25,11508,280255,5263,130204,6245,150051,0,0,8529,191721,2972,44714,8667,236435,California
San Diego,2021-01-26,13801,294056,6744,136948,7057,157108,0,0,10549,199210,3247,47961,10736,247171,California
San Diego,2021-01-27,19303,313359,7107,144055,12196,169304,0,0,16275,212573,3014,50975,16377,263548,California
San Diego,2021-01-28,19963,333322,6661,150716,13302,182606,0,0,17718,228147,2235,53210,17809,281357,California
San Diego,2021-01-29,18949,352271,5974,156690,12975,195581,0,0,16539,242344,2400,55610,16597,297954,California
San Diego,2021-01-30,15191,367462,3255,159945,11936,207517,0,0,12514,252294,2666,58276,12616,310570,California
San Diego,2021-01-31,13514,380976,4920,164865,8594,216111,0,0,13165,265137,346,58622,13189,323759,California
San Diego,2021-02-01,19175,400151,6373,171238,12802,228913,0,0,15997,278054,3165,61787,16082,339841,California
San Diego,2021-02-02,21532,421683,7571,178809,13961,242874,0,0,17981,292694,3539,65326,18179,358020,California
San Diego,2021-02-03,25552,447235,10454,189263,15098,257972,0,0,21390,310143,4142,69468,21591,379611,California
San Diego,2021-02-04,22745,469980,9030,198293,13715,271687,0,0,18066,323829,4662,74130,18348,397959,California
San Diego,2021-02-05,24204,494184,8784,207077,15420,287107,0,0,17637,335471,6543,80673,18185,416144,California
San Diego,2021-02-06,19743,513927,8025,215102,11718,298825,0,0,16551,349057,3182,83855,16768,432912,California
San Diego,2021-02-07,10944,524871,4640,219742,6304,305129,0,0,8989,356454,1936,85791,9333,442245,California
San Diego,2021-02-08,18939,543810,7912,227654,11027,316156,0,0,11583,361477,7337,93128,12360,454605,California
San Diego,2021-02-09,19035,562845,7586,235240,11449,327605,0,0,11892,367369,7123,100251,13015,467620,California
San Diego,2021-02-10,21745,584590,8798,244038,12947,340552,0,0,12748,372601,8969,109220,14201,481821,California
San Diego,2021-02-11,22431,607021,9745,253783,12686,353238,0,0,11506,374885,10897,120117,13181,495002,California
San Diego,2021-02-12,22942,629963,6947,260730,15995,369233,0,0,11183,376599,11739,131856,13453,508455,California
San Diego,2021-02-13,19194,649157,8441,269171,10753,379986,0,0,10158,379031,9026,140882,11458,519913,California
San Diego,2021-02-14,10291,659448,6554,275725,3737,383723,0,0,5660,381807,4628,145510,7404,527317,California
San Diego,2021-02-15,14483,673931,7068,282793,7415,391138,0,0,7422,385232,7046,152556,10471,537788,California
San Diego,2021-02-16,17928,691859,10099,292892,7829,398967,0,0,8372,387468,9542,162098,11778,549566,California
San Diego,2021-02-17,21777,713636,9550,302442,12227,411194,0,0,7086,383514,14679,176777,10725,560291,California
San Diego,2021-02-18,22161,735797,11034,313476,11127,422321,0,0,7028,379874,15126,191903,11486,571777,California
San Diego,2021-02-19,15138,750935,10382,323858,4756,427077,0,0,6181,379268,8936,200839,8330,580107,California
San Diego,2021-02-20,9609,760544,5820,329678,3789,430866,0,0,5578,382691,4027,204866,7450,587557,California
San Diego,2021-02-21,9349,769893,8119,337797,1230,432096,0,0,4213,382874,5111,209977,5294,592851,California
San Diego,2021-02-22,11011,780904,9249,347046,1762,433858,0,0,5340,383674,5666,215643,6466,599317,California
San Diego,2021-02-23,23726,804630,12674,359720,11052,444910,0,0,8852,383027,14865,230508,14218,613535,California
San Diego,2021-02-24,27081,831711,11407,371127,15674,460584,0,0,6501,375801,20564,251072,13338,626873,California
San Diego,2021-02-25,31392,863103,13326,384453,18066,478650,0,0,9610,371279,21757,272829,17235,644108,California
San Diego,2021-02-26,32324,895427,11768,396221,20556,499206,0,0,11470,368909,20826,293655,18456,662564,California
San Diego,2021-02-27,20460,915887,8937,405158,11523,510729,0,0,11045,374828,9407,303062,15326,677890,California
San Diego,2021-02-28,13619,929506,8506,413664,5113,515842,0,0,8729,381200,4890,307952,11262,689152,California
San Diego,2021-03-01,23002,952508,13275,426939,9727,525569,0,0,14092,390413,8825,316777,18038,707190,California
San Diego,2021-03-02,24993,977501,13203,440142,11790,537359,0,0,12371,396847,12604,329381,19038,726228,California
San Diego,2021-03-03,32327,1009828,14964,455106,17360,554719,3,3,13380,398467,18893,348274,20513,746741,California
San Diego,2021-03-04,27367,1037195,13443,468549,13924,568643,0,3,12271,403795,15068,363342,20396,767137,California
San Diego,2021-03-05,27826,1065021,14135,482684,13610,582253,81,84,13221,409364,14560,377902,20129,787266,California
San Diego,2021-03-06,22568,1087589,9166,491850,12703,594956,699,783,10233,412742,12302,390204,15680,802946,California
San Diego,2021-03-07,17257,1104846,8688,500538,8004,602960,565,1348,7303,415215,9943,400147,12416,815362,California
San Diego,2021-03-08,22331,1127177,10831,511369,10693,613653,807,2155,11050,421762,11272,411419,17819,833181,California
San Diego,2021-03-09,25019,1152196,11625,522994,11787,625440,1607,3762,10374,424614,14625,426044,17477,850658,California
San Diego,2021-03-10,24342,1176538,10425,533419,11573,637013,2344,6106,10011,427258,14315,440359,16959,867617,California
San Diego,2021-03-11,27269,1203807,10458,543877,13481,650494,3330,9436,10102,430134,17146,457505,20022,887639,California
San Diego,2021-03-12,25046,1228853,8392,552269,13647,664141,3007,12443,9073,430288,15930,473435,16084,903723,California
San Diego,2021-03-13,23666,1252519,6558,558827,15627,679768,1481,13924,9014,430755,14643,488078,15110,918833,California
San Diego,2021-03-14,11485,1264004,4329,563156,6479,686247,677,14601,3704,429894,7772,495850,6911,925744,California
San Diego,2021-03-15,21201,1285205,9716,572872,10745,696992,740,15341,9260,431373,11923,507773,13402,939146,California
San Diego,2021-03-16,28616,1313821,15066,587938,13174,710166,376,15717,15434,437387,13162,520935,19176,958322,California
San Diego,2021-03-17,25073,1338894,11574,599512,12856,723022,643,16360,16039,447492,9020,529955,19125,977447,California
San Diego,2021-03-18,22591,1361485,12256,611768,9643,732665,692,17052,11355,450226,11206,541161,13940,991387,California
San Diego,2021-03-19,11504,1372989,3645,615413,7171,739836,688,17740,6302,453656,5196,546357,8626,1000013,California
Alpine,2020-12-18,2,2,2,2,0,0,0,0,2,2,0,0,2,2,California
Alpine,2020-12-19,2,4,2,4,0,0,0,0,2,4,0,0,2,4,California
Alpine,2020-12-21,2,6,2,6,0,0,0,0,2,6,0,0,2,6,California
Alpine,2020-12-30,15,21,0,6,15,15,0,0,15,21,0,0,15,21,California
Alpine,2020-12-31,1,22,0,6,1,16,0,0,1,22,0,0,1,22,California
Alpine,2021-01-02,1,23,1,7,0,16,0,0,1,23,0,0,1,23,California
Alpine,2021-01-04,10,33,0,7,10,26,0,0,10,33,0,0,10,33,California
Alpine,2021-01-05,9,42,1,8,8,34,0,0,9,42,0,0,9,42,California
Alpine,2021-01-06,31,73,0,8,31,65,0,0,31,73,0,0,31,73,California
Alpine,2021-01-07,8,81,0,8,8,73,0,0,8,81,0,0,8,81,California
Alpine,2021-01-08,4,85,2,10,2,75,0,0,2,81,2,2,2,83,California
Alpine,2021-01-09,2,87,2,12,0,75,0,0,0,79,2,4,0,83,California
Alpine,2021-01-11,30,117,1,13,29,104,0,0,29,107,1,5,29,112,California
Alpine,2021-01-13,32,149,0,13,32,136,0,0,32,139,0,5,32,144,California
Alpine,2021-01-14,2,151,0,13,2,138,0,0,2,141,0,5,2,146,California
Alpine,2021-01-15,1,152,0,13,1,139,0,0,1,142,0,5,1,147,California
Alpine,2021-01-20,19,171,0,13,19,158,0,0,19,161,0,5,19,166,California
Alpine,2021-01-21,3,174,0,13,3,161,0,0,3,164,0,5,3,169,California
Alpine,2021-01-22,31,205,0,13,31,192,0,0,31,195,0,5,31,200,California
Alpine,2021-01-23,1,206,1,14,0,192,0,0,0,194,1,6,0,200,California
Alpine,2021-01-25,16,222,0,14,16,208,0,0,16,210,0,6,16,216,California
Alpine,2021-01-27,1,223,1,15,0,208,0,0,0,209,1,7,0,216,California
Alpine,2021-01-28,12,235,0,15,12,220,0,0,11,219,1,8,11,227,California
Alpine,2021-02-01,24,259,0,15,24,244,0,0,6,207,18,26,6,233,California
Alpine,2021-02-03,33,292,0,15,33,277,0,0,9,192,24,50,9,242,California
Alpine,2021-02-04,9,301,0,15,9,286,0,0,4,191,5,55,4,246,California
Alpine,2021-02-05,30,331,0,15,30,316,0,0,11,183,19,74,11,257,California
Alpine,2021-02-06,1,332,1,16,0,316,0,0,1,184,0,74,1,258,California
Alpine,2021-02-07,1,333,1,17,0,316,0,0,1,185,0,74,1,259,California
Alpine,2021-02-08,32,365,0,17,32,348,0,0,4,162,28,102,5,264,California
Alpine,2021-02-10,32,397,0,17,32,380,0,0,0,132,32,134,2,266,California
Alpine,2021-02-11,8,405,0,17,8,388,0,0,5,134,3,137,5,271,California
Alpine,2021-02-12,2,407,0,17,2,390,0,0,1,134,1,138,1,272,California
Alpine,2021-02-17,22,429,1,18,21,411,0,0,4,120,18,156,4,276,California
Alpine,2021-02-18,4,433,0,18,4,415,0,0,1,118,3,159,1,277,California
Alpine,2021-02-19,34,467,1,19,33,448,0,0,2,89,32,191,3,280,California
Alpine,2021-02-22,28,495,0,19,28,476,0,0,9,79,19,210,9,289,California
Alpine,2021-02-25,17,512,1,20,16,492,0,0,6,74,11,221,6,295,California
Alpine,2021-02-26,29,541,1,21,28,520,0,0,28,101,1,222,28,323,California
Alpine,2021-03-01,33,574,0,21,33,553,0,0,24,116,9,231,24,347,California
Alpine,2021-03-02,1,575,1,22,0,553,0,0,0,115,1,232,0,347,California
Alpine,2021-03-03,30,605,1,23,29,582,0,0,18,121,12,244,18,365,California
Alpine,2021-03-04,13,618,1,24,12,594,0,0,12,132,1,245,12,377,California
Alpine,2021-03-05,30,648,0,24,30,624,0,0,22,147,8,253,23,400,California
Alpine,2021-03-08,28,676,0,24,28,652,0,0,26,171,2,255,26,426,California
Alpine,2021-03-09,1,677,0,24,1,653,0,0,1,172,0,255,1,427,California
Alpine,2021-03-10,75,752,1,25,74,727,0,0,74,245,1,256,74,501,California
Alpine,2021-03-11,37,789,0,25,37,764,0,0,32,273,4,260,32,533,California
Alpine,2021-03-12,22,811,0,25,22,786,0,0,19,289,3,263,19,552,California
Alpine,2021-03-15,20,831,0,25,20,806,0,0,19,307,1,264,19,571,California
Alpine,2021-03-17,22,853,0,25,21,827,1,1,18,322,4,268,19,590,California
Alpine,2021-03-18,38,891,1,26,37,864,0,1,36,356,2,270,36,626,California
Alpine,2021-03-19,1,892,1,27,0,864,0,1,1,357,0,270,1,627,California
Glenn,2020-12-17,1,1,1,1,0,0,0,0,1,1,0,0,1,1,California
Glenn,2020-12-19,1,2,1,2,0,0,0,0,1,2,0,0,1,2,California
Glenn,2020-12-20,1,3,1,3,0,0,0,0,1,3,0,0,1,3,California
Glenn,2020-12-21,11,14,11,14,0,0,0,0,11,14,0,0,11,14,California
Glenn,2020-12-22,59,73,59,73,0,0,0,0,59,73,0,0,59,73,California
Glenn,2020-12-23,26,99,26,99,0,0,0,0,26,99,0,0,26,99,California
Glenn,2020-12-24,9,108,9,108,0,0,0,0,9,108,0,0,9,108,California
Glenn,2020-12-26,2,110,2,110,0,0,0,0,2,110,0,0,2,110,California
Glenn,2020-12-27,4,114,4,114,0,0,0,0,4,114,0,0,4,114,California
Glenn,2020-12-28,20,134,20,134,0,0,0,0,20,134,0,0,20,134,California
Glenn,2020-12-29,82,216,82,216,0,0,0,0,82,216,0,0,82,216,California
Glenn,2020-12-30,129,345,107,323,22,22,0,0,129,345,0,0,129,345,California
Glenn,2020-12-31,38,383,9,332,29,51,0,0,38,383,0,0,38,383,California
Glenn,2021-01-02,2,385,2,334,0,51,0,0,2,385,0,0,2,385,California
Glenn,2021-01-04,7,392,5,339,2,53,0,0,7,392,0,0,7,392,California
Glenn,2021-01-05,9,401,8,347,1,54,0,0,9,401,0,0,9,401,California
Glenn,2021-01-06,61,462,9,356,52,106,0,0,61,462,0,0,61,462,California
Glenn,2021-01-07,66,528,12,368,54,160,0,0,64,524,2,2,64,526,California
Glenn,2021-01-08,11,539,9,377,2,162,0,0,11,535,0,2,11,537,California
Glenn,2021-01-10,1,540,1,378,0,162,0,0,0,534,1,3,0,537,California
Glenn,2021-01-11,30,570,30,408,0,162,0,0,12,528,18,21,12,549,California
Glenn,2021-01-12,42,612,37,445,5,167,0,0,14,514,28,49,14,563,California
Glenn,2021-01-13,153,765,88,533,65,232,0,0,110,581,43,92,110,673,California
Glenn,2021-01-14,183,948,95,628,88,320,0,0,173,744,10,102,173,846,California
Glenn,2021-01-15,42,990,34,662,8,328,0,0,37,776,5,107,37,883,California
Glenn,2021-01-16,34,1024,14,676,20,348,0,0,24,790,10,117,24,907,California
Glenn,2021-01-17,4,1028,2,678,2,350,0,0,2,790,2,119,2,909,California
Glenn,2021-01-18,17,1045,16,694,1,351,0,0,9,791,8,127,9,918,California
Glenn,2021-01-19,28,1073,18,712,10,361,0,0,12,787,16,143,12,930,California
Glenn,2021-01-20,162,1235,93,805,69,430,0,0,81,787,81,224,81,1011,California
Glenn,2021-01-21,124,1359,98,903,26,456,0,0,29,721,95,319,29,1040,California
Glenn,2021-01-22,337,1696,63,966,274,730,0,0,330,1044,7,326,330,1370,California
Glenn,2021-01-23,14,1710,7,973,7,737,0,0,12,1054,2,328,12,1382,California
Glenn,2021-01-24,1,1711,1,974,0,737,0,0,1,1055,0,328,1,1383,California
Glenn,2021-01-25,27,1738,9,983,18,755,0,0,24,1076,3,331,24,1407,California
Glenn,2021-01-26,29,1767,13,996,16,771,0,0,23,1093,6,337,23,1430,California
Glenn,2021-01-27,188,1955,14,1010,174,945,0,0,166,1237,22,359,166,1596,California
Glenn,2021-01-28,145,2100,8,1018,137,1082,0,0,115,1322,30,389,115,1711,California
Glenn,2021-01-29,296,2396,11,1029,285,1367,0,0,282,1590,14,403,282,1993,California
Glenn,2021-01-30,4,2400,0,1029,4,1371,0,0,4,1594,0,403,4,1997,California
Glenn,2021-01-31,1,2401,0,1029,1,1372,0,0,1,1595,0,403,1,1998,California
Glenn,2021-02-01,29,2430,10,1039,19,1391,0,0,17,1600,12,415,17,2015,California
Glenn,2021-02-02,27,2457,12,1051,15,1406,0,0,18,1609,9,424,18,2033,California
Glenn,2021-02-03,206,2663,58,1109,148,1554,0,0,111,1625,95,519,111,2144,California
Glenn,2021-02-04,146,2809,82,1191,64,1618,0,0,43,1565,103,622,43,2187,California
Glenn,2021-02-05,320,3129,24,1215,296,1914,0,0,301,1847,19,641,301,2488,California
Glenn,2021-02-06,14,3143,1,1216,13,1927,0,0,13,1859,1,642,13,2501,California
Glenn,2021-02-07,1,3144,1,1217,0,1927,0,0,1,1860,0,642,1,2502,California
Glenn,2021-02-08,21,3165,17,1234,4,1931,0,0,4,1847,17,659,4,2506,California
Glenn,2021-02-09,48,3213,19,1253,29,1960,0,0,36,1871,12,671,36,2542,California
Glenn,2021-02-10,137,3350,19,1272,118,2078,0,0,63,1860,74,745,63,2605,California
Glenn,2021-02-11,233,3583,134,1406,99,2177,0,0,151,1929,82,827,151,2756,California
Glenn,2021-02-12,422,4005,100,1506,322,2499,0,0,358,2223,64,891,358,3114,California
Glenn,2021-02-13,33,4038,7,1513,26,2525,0,0,15,2220,18,909,15,3129,California
Glenn,2021-02-14,1,4039,0,1513,1,2526,0,0,1,2221,0,909,1,3130,California
Glenn,2021-02-15,8,4047,0,1513,8,2534,0,0,8,2229,0,909,8,3138,California
Glenn,2021-02-16,38,4085,9,1522,29,2563,0,0,20,2231,18,927,20,3158,California
Glenn,2021-02-17,380,4465,15,1537,365,2928,0,0,302,2455,78,1005,302,3460,California
Glenn,2021-02-18,137,4602,102,1639,35,2963,0,0,113,2544,24,1029,113,3573,California
Glenn,2021-02-19,302,4904,16,1655,286,3249,0,0,29,2300,273,1302,29,3602,California
Glenn,2021-02-20,8,4912,0,1655,8,3257,0,0,0,2292,8,1310,0,3602,California
Glenn,2021-02-22,31,4943,12,1667,19,3276,0,0,15,2291,16,1326,15,3617,California
Glenn,2021-02-23,38,4981,10,1677,28,3304,0,0,26,2306,11,1337,26,3643,California
Glenn,2021-02-24,220,5201,13,1690,207,3511,0,0,49,2184,171,1508,49,3692,California
Glenn,2021-02-25,258,5459,143,1833,115,3626,0,0,117,2160,141,1649,117,3809,California
Glenn,2021-02-26,303,5762,24,1857,279,3905,0,0,20,1897,283,1932,20,3829,California
Glenn,2021-02-27,14,5776,5,1862,9,3914,0,0,6,1896,7,1939,6,3835,California
Glenn,2021-02-28,5,5781,2,1864,3,3917,0,0,3,1898,1,1940,3,3838,California
Glenn,2021-03-01,28,5809,6,1870,22,3939,0,0,11,1892,17,1957,11,3849,California
Glenn,2021-03-02,33,5842,6,1876,27,3966,0,0,14,1887,19,1976,14,3863,California
Glenn,2021-03-03,174,6016,24,1900,150,4116,0,0,84,1882,89,2065,84,3947,California
Glenn,2021-03-04,388,6404,90,1990,298,4414,0,0,304,2102,84,2149,304,4251,California
Glenn,2021-03-05,329,6733,45,2035,284,4698,0,0,32,1837,297,2446,32,4283,California
Glenn,2021-03-06,28,6761,4,2039,23,4721,1,1,11,1832,17,2463,12,4295,California
Glenn,2021-03-07,4,6765,0,2039,4,4725,0,1,3,1834,1,2464,3,4298,California
Glenn,2021-03-08,20,6785,2,2041,17,4742,1,2,18,1851,2,2466,19,4317,California
Glenn,2021-03-09,56,6841,10,2051,43,4785,3,5,38,1874,18,2484,41,4358,California
Glenn,2021-03-10,113,6954,38,2089,73,4858,2,7,58,1879,55,2539,60,4418,California
Glenn,2021-03-11,494,7448,166,2255,314,5172,14,21,373,2145,121,2660,387,4805,California
Glenn,2021-03-12,398,7846,12,2267,336,5508,50,71,35,1867,363,3023,85,4890,California
Glenn,2021-03-13,10,7856,1,2268,1,5509,8,79,0,1865,10,3033,8,4898,California
Glenn,2021-03-14,3,7859,1,2269,2,5511,0,79,2,1866,1,3034,2,4900,California
Glenn,2021-03-15,67,7926,16,2285,48,5559,3,82,54,1910,13,3047,57,4957,California
Glenn,2021-03-16,89,8015,30,2315,49,5608,10,92,54,1939,35,3082,64,5021,California
Glenn,2021-03-17,402,8417,98,2413,303,5911,1,93,105,1747,297,3379,105,5126,California
Glenn,2021-03-18,272,8689,132,2545,30,5941,110,203,86,1757,186,3565,196,5322,California
Glenn,2021-03-19,38,8727,10,2555,24,5965,4,207,23,1769,15,3580,27,5349,California
Siskiyou,2020-12-16,2,2,2,2,0,0,0,0,2,2,0,0,2,2,California
Siskiyou,2020-12-17,4,6,4,6,0,0,0,0,4,6,0,0,4,6,California
Siskiyou,2020-12-18,3,9,3,9,0,0,0,0,3,9,0,0,3,9,California
Siskiyou,2020-12-19,4,13,4,13,0,0,0,0,4,13,0,0,4,13,California
Siskiyou,2020-12-20,1,14,1,14,0,0,0,0,1,14,0,0,1,14,California
Siskiyou,2020-12-21,132,146,132,146,0,0,0,0,132,146,0,0,132,146,California
Siskiyou,2020-12-22,159,305,159,305,0,0,0,0,159,305,0,0,159,305,California
Siskiyou,2020-12-23,142,447,142,447,0,0,0,0,142,447,0,0,142,447,California
Siskiyou,2020-12-24,5,452,5,452,0,0,0,0,5,452,0,0,5,452,California
Siskiyou,2020-12-26,2,454,0,452,2,2,0,0,2,454,0,0,2,454,California
Siskiyou,2020-12-27,2,456,0,452,2,4,0,0,2,456,0,0,2,456,California
Siskiyou,2020-12-28,2,458,0,452,2,6,0,0,2,458,0,0,2,458,California
Siskiyou,2020-12-29,6,464,2,454,4,10,0,0,6,464,0,0,6,464,California
Siskiyou,2020-12-30,97,561,2,456,95,105,0,0,97,561,0,0,97,561,California
Siskiyou,2020-12-31,12,573,0,456,12,117,0,0,12,573,0,0,12,573,California
Siskiyou,2021-01-02,1,574,1,457,0,117,0,0,1,574,0,0,1,574,California
Siskiyou,2021-01-03,1,575,0,457,1,118,0,0,1,575,0,0,1,575,California
Siskiyou,2021-01-04,130,705,3,460,127,245,0,0,130,705,0,0,130,705,California
Siskiyou,2021-01-05,117,822,4,464,113,358,0,0,116,820,1,1,116,821,California
Siskiyou,2021-01-06,59,881,6,470,53,411,0,0,55,871,4,5,55,876,California
Siskiyou,2021-01-07,174,1055,2,472,172,583,0,0,173,1043,1,6,173,1049,California
Siskiyou,2021-01-08,42,1097,4,476,38,621,0,0,39,1079,3,9,39,1088,California
Siskiyou,2021-01-09,2,1099,2,478,0,621,0,0,0,1077,2,11,0,1088,California
Siskiyou,2021-01-11,226,1325,65,543,161,782,0,0,163,1177,63,74,163,1251,California
Siskiyou,2021-01-12,320,1645,273,816,47,829,0,0,87,1031,233,307,87,1338,California
Siskiyou,2021-01-13,157,1802,137,953,20,849,0,0,23,920,134,441,23,1361,California
Siskiyou,2021-01-14,26,1828,1,954,25,874,0,0,25,944,1,442,25,1386,California
Siskiyou,2021-01-15,35,1863,3,957,32,906,0,0,35,979,0,442,35,1421,California
Siskiyou,2021-01-16,7,1870,2,959,5,911,0,0,7,986,0,442,7,1428,California
Siskiyou,2021-01-18,75,1945,4,963,71,982,0,0,73,1057,2,444,73,1501,California
Siskiyou,2021-01-19,21,1966,1,964,20,1002,0,0,20,1076,1,445,20,1521,California
Siskiyou,2021-01-20,45,2011,33,997,12,1014,0,0,42,1115,3,448,42,1563,California
Siskiyou,2021-01-21,42,2053,0,997,42,1056,0,0,42,1157,0,448,42,1605,California
Siskiyou,2021-01-22,1332,3385,1181,2178,151,1207,0,0,1332,2489,0,448,1332,2937,California
Siskiyou,2021-01-23,6,3391,2,2180,4,1211,0,0,3,2489,3,451,3,2940,California
Siskiyou,2021-01-25,183,3574,8,2188,175,1386,0,0,179,2664,4,455,179,3119,California
Siskiyou,2021-01-26,150,3724,5,2193,145,1531,0,0,142,2798,8,463,142,3261,California
Siskiyou,2021-01-27,180,3904,0,2193,180,1711,0,0,126,2870,54,517,126,3387,California
Siskiyou,2021-01-28,228,4132,114,2307,114,1825,0,0,222,3086,6,523,222,3609,California
Siskiyou,2021-01-29,245,4377,0,2307,245,2070,0,0,243,3327,2,525,243,3852,California
Siskiyou,2021-01-30,3,4380,2,2309,1,2071,0,0,3,3330,0,525,3,3855,California
Siskiyou,2021-02-01,194,4574,3,2312,191,2262,0,0,104,3344,90,615,104,3959,California
Siskiyou,2021-02-02,287,4861,44,2356,243,2505,0,0,146,3349,141,756,146,4105,California
Siskiyou,2021-02-03,311,5172,1,2357,310,2815,0,0,262,3562,49,805,262,4367,California
Siskiyou,2021-02-04,315,5487,3,2360,312,3127,0,0,195,3637,120,925,195,4562,California
Siskiyou,2021-02-05,509,5996,4,2364,505,3632,0,0,345,3818,164,1089,345,4907,California
Siskiyou,2021-02-06,15,6011,0,2364,15,3647,0,0,15,3833,0,1089,15,4922,California
Siskiyou,2021-02-07,3,6014,2,2366,1,3648,0,0,3,3836,0,1089,3,4925,California
Siskiyou,2021-02-08,220,6234,4,2370,216,3864,0,0,215,4046,5,1094,215,5140,California
Siskiyou,2021-02-09,188,6422,2,2372,186,4050,0,0,155,4168,33,1127,155,5295,California
Siskiyou,2021-02-10,367,6789,37,2409,330,4380,0,0,315,4431,52,1179,315,5610,California
Siskiyou,2021-02-11,185,6974,0,2409,185,4565,0,0,170,4586,15,1194,170,5780,California
Siskiyou,2021-02-12,1681,8655,1205,3614,476,5041,0,0,486,3877,1195,2389,486,6266,California
Siskiyou,2021-02-13,36,8691,3,3617,33,5074,0,0,31,3903,5,2394,31,6297,California
Siskiyou,2021-02-14,5,8696,1,3618,4,5078,0,0,5,3908,0,2394,5,6302,California
Siskiyou,2021-02-15,103,8799,7,3625,96,5174,0,0,100,4005,3,2397,100,6402,California
Siskiyou,2021-02-16,110,8909,4,3629,106,5280,0,0,93,4081,17,2414,93,6495,California
Siskiyou,2021-02-17,183,9092,19,3648,164,5444,0,0,171,4240,12,2426,171,6666,California
Siskiyou,2021-02-18,220,9312,88,3736,132,5576,0,0,100,4220,120,2546,100,6766,California
Siskiyou,2021-02-19,58,9370,22,3758,36,5612,0,0,24,4210,34,2580,24,6790,California
Siskiyou,2021-02-20,21,9391,4,3762,17,5629,0,0,17,4223,4,2584,17,6807,California
Siskiyou,2021-02-21,2,9393,2,3764,0,5629,0,0,2,4225,0,2584,2,6809,California
Siskiyou,2021-02-22,125,9518,2,3766,123,5752,0,0,18,4136,107,2691,18,6827,California
Siskiyou,2021-02-23,192,9710,14,3780,178,5930,0,0,49,4042,143,2834,49,6876,California
Siskiyou,2021-02-24,145,9855,3,3783,142,6072,0,0,33,3963,112,2946,33,6909,California
Siskiyou,2021-02-25,294,10149,22,3805,272,6344,0,0,148,3965,146,3092,148,7057,California
Siskiyou,2021-02-26,661,10810,13,3818,648,6992,0,0,366,4036,295,3387,366,7423,California
Siskiyou,2021-02-27,30,10840,3,3821,27,7019,0,0,26,4058,4,3391,26,7449,California
Siskiyou,2021-02-28,3,10843,3,3824,0,7019,0,0,2,4059,1,3392,2,7451,California
Siskiyou,2021-03-01,271,11114,6,3830,265,7284,0,0,43,3874,228,3620,43,7494,California
Siskiyou,2021-03-02,177,11291,0,3830,177,7461,0,0,68,3833,109,3729,68,7562,California
Siskiyou,2021-03-03,329,11620,4,3834,325,7786,0,0,144,3793,184,3913,144,7706,California
Siskiyou,2021-03-04,660,12280,493,4327,167,7953,0,0,512,4157,148,4061,512,8218,California
Siskiyou,2021-03-05,242,12522,8,4335,223,8176,11,11,40,4006,202,4263,51,8269,California
Siskiyou,2021-03-06,35,12557,2,4337,29,8205,4,15,28,4031,7,4270,32,8301,California
Siskiyou,2021-03-07,10,12567,3,4340,0,8205,7,22,2,4032,8,4278,9,8310,California
Siskiyou,2021-03-08,340,12907,25,4365,282,8487,33,55,47,3819,293,4571,80,8390,California
Siskiyou,2021-03-09,93,13000,0,4365,77,8564,16,71,35,3812,58,4629,51,8441,California
Siskiyou,2021-03-10,158,13158,11,4376,141,8705,6,77,21,3702,137,4766,27,8468,California
Siskiyou,2021-03-11,421,13579,175,4551,205,8910,41,118,238,3800,181,4947,279,8747,California
Siskiyou,2021-03-12,422,14001,112,4663,277,9187,33,151,150,3712,271,5218,183,8930,California
Siskiyou,2021-03-13,331,14332,301,4964,8,9195,22,173,300,4003,31,5249,322,9252,California
Siskiyou,2021-03-14,20,14352,3,4967,2,9197,15,188,4,4006,16,5265,19,9271,California
Siskiyou,2021-03-15,430,14782,238,5205,175,9372,17,205,304,4201,126,5391,321,9592,California
Siskiyou,2021-03-16,251,15033,41,5246,193,9565,17,222,142,4251,109,5500,159,9751,California
Siskiyou,2021-03-17,186,15219,4,5250,176,9741,6,228,27,4125,159,5659,33,9784,California
Siskiyou,2021-03-18,681,15900,603,5853,78,9819,0,228,611,4666,70,5729,611,10395,California
Siskiyou,2021-03-19,18,15918,6,5859,12,9831,0,228,6,4660,12,5741,6,10401,California
Plumas,2020-12-18,4,4,4,4,0,0,0,0,4,4,0,0,4,4,California
Plumas,2020-12-19,1,5,1,5,0,0,0,0,1,5,0,0,1,5,California
Plumas,2020-12-21,45,50,45,50,0,0,0,0,45,50,0,0,45,50,California
Plumas,2020-12-22,92,142,92,142,0,0,0,0,92,142,0,0,92,142,California
Plumas,2020-12-23,50,192,50,192,0,0,0,0,50,192,0,0,50,192,California
Plumas,2020-12-24,6,198,6,198,0,0,0,0,6,198,0,0,6,198,California
Plumas,2020-12-28,8,206,0,198,8,8,0,0,8,206,0,0,8,206,California
Plumas,2020-12-29,32,238,22,220,10,18,0,0,32,238,0,0,32,238,California
Plumas,2020-12-30,22,260,1,221,21,39,0,0,22,260,0,0,22,260,California
Plumas,2020-12-31,4,264,1,222,3,42,0,0,4,264,0,0,4,264,California
Plumas,2021-01-04,9,273,3,225,6,48,0,0,9,273,0,0,9,273,California
Plumas,2021-01-05,23,296,2,227,21,69,0,0,22,295,0,0,22,295,California
Plumas,2021-01-06,125,421,6,233,119,188,0,0,125,420,0,0,125,420,California
Plumas,2021-01-07,55,476,2,235,53,241,0,0,54,473,1,1,54,474,California
Plumas,2021-01-08,12,488,5,240,7,248,0,0,8,477,4,5,8,482,California
Plumas,2021-01-09,2,490,2,242,0,248,0,0,1,477,1,6,1,483,California
Plumas,2021-01-11,59,549,50,292,9,257,0,0,12,442,47,53,12,495,California
Plumas,2021-01-12,154,703,86,378,68,325,0,0,70,428,84,137,70,565,California
Plumas,2021-01-13,55,758,50,428,5,330,0,0,9,391,46,183,9,574,California
Plumas,2021-01-14,96,854,14,442,82,412,0,0,91,477,5,188,91,665,California
Plumas,2021-01-15,62,916,7,449,55,467,0,0,60,535,2,190,60,725,California
Plumas,2021-01-16,58,974,1,450,57,524,0,0,58,593,0,190,58,783,California
Plumas,2021-01-18,2,976,1,451,1,525,0,0,2,595,0,190,2,785,California
Plumas,2021-01-19,37,1013,6,457,31,556,0,0,33,624,4,194,33,818,California
Plumas,2021-01-20,121,1134,3,460,118,674,0,0,119,741,2,196,119,937,California
Plumas,2021-01-21,112,1246,2,462,110,784,0,0,112,853,0,196,112,1049,California
Plumas,2021-01-22,3,1249,0,462,3,787,0,0,3,856,0,196,3,1052,California
Plumas,2021-01-23,92,1341,1,463,91,878,0,0,92,948,0,196,92,1144,California
Plumas,2021-01-24,1,1342,1,464,0,878,0,0,1,949,0,196,1,1145,California
Plumas,2021-01-25,9,1351,6,470,3,881,0,0,6,952,3,199,6,1151,California
Plumas,2021-01-26,60,1411,2,472,58,939,0,0,52,996,8,207,52,1203,California
Plumas,2021-01-27,25,1436,20,492,5,944,0,0,5,981,20,227,5,1208,California
Plumas,2021-01-28,23,1459,0,492,23,967,0,0,21,1000,2,229,21,1229,California
Plumas,2021-01-29,7,1466,2,494,5,972,0,0,6,1005,1,230,6,1235,California
Plumas,2021-01-30,7,1473,4,498,3,975,0,0,6,1010,1,231,6,1241,California
Plumas,2021-01-31,3,1476,3,501,0,975,0,0,3,1013,0,231,3,1244,California
Plumas,2021-02-01,15,1491,2,503,13,988,0,0,7,1012,8,239,7,1251,California
Plumas,2021-02-02,20,1511,1,504,19,1007,0,0,1,994,19,258,1,1252,California
Plumas,2021-02-03,127,1638,5,509,122,1129,0,0,13,894,113,371,13,1265,California
Plumas,2021-02-04,102,1740,8,517,94,1223,0,0,23,838,79,450,23,1288,California
Plumas,2021-02-05,24,1764,11,528,13,1236,0,0,8,830,16,466,8,1296,California
Plumas,2021-02-06,8,1772,1,529,7,1243,0,0,8,838,0,466,8,1304,California
Plumas,2021-02-08,16,1788,8,537,8,1251,0,0,4,830,12,478,4,1308,California
Plumas,2021-02-09,170,1958,1,538,169,1420,0,0,111,882,59,537,111,1419,California
Plumas,2021-02-10,91,2049,8,546,83,1503,0,0,83,957,8,545,83,1502,California
Plumas,2021-02-11,320,2369,6,552,314,1817,0,0,261,1159,59,604,261,1763,California
Plumas,2021-02-12,121,2490,3,555,118,1935,0,0,117,1272,4,608,117,1880,California
Plumas,2021-02-13,72,2562,3,558,69,2004,0,0,13,1226,59,667,13,1893,California
Plumas,2021-02-14,7,2569,4,562,3,2007,0,0,7,1233,0,667,7,1900,California
Plumas,2021-02-15,26,2595,4,566,22,2029,0,0,24,1255,2,669,24,1924,California
Plumas,2021-02-16,74,2669,4,570,70,2099,0,0,13,1207,61,730,13,1937,California
Plumas,2021-02-17,133,2802,5,575,128,2227,0,0,11,1096,122,852,11,1948,California
Plumas,2021-02-18,125,2927,5,580,120,2347,0,0,17,1005,108,960,17,1965,California
Plumas,2021-02-19,38,2965,3,583,35,2382,0,0,5,977,33,993,5,1970,California
Plumas,2021-02-20,101,3066,6,589,95,2477,0,0,9,894,92,1085,9,1979,California
Plumas,2021-02-21,6,3072,5,594,1,2478,0,0,2,892,4,1089,2,1981,California
Plumas,2021-02-22,5,3077,3,597,2,2480,0,0,1,889,4,1093,1,1982,California
Plumas,2021-02-23,21,3098,4,601,17,2497,0,0,14,896,7,1100,14,1996,California
Plumas,2021-02-24,449,3547,6,607,443,2940,0,0,439,1325,10,1110,439,2435,California
Plumas,2021-02-25,221,3768,4,611,217,3157,0,0,162,1428,59,1169,162,2597,California
Plumas,2021-02-26,255,4023,5,616,250,3407,0,0,251,1675,4,1173,251,2848,California
Plumas,2021-02-27,42,4065,6,622,36,3443,0,0,34,1701,8,1181,34,2882,California
Plumas,2021-03-01,11,4076,4,626,7,3450,0,0,7,1704,4,1185,7,2889,California
Plumas,2021-03-02,9,4085,0,626,9,3459,0,0,6,1707,3,1188,6,2895,California
Plumas,2021-03-03,138,4223,8,634,130,3589,0,0,124,1817,14,1202,124,3019,California
Plumas,2021-03-04,212,4435,9,643,203,3792,0,0,193,1991,19,1221,193,3212,California
Plumas,2021-03-05,370,4805,5,648,359,4151,6,6,360,2347,10,1231,366,3578,California
Plumas,2021-03-06,16,4821,1,649,7,4158,8,14,3,2345,13,1244,11,3589,California
Plumas,2021-03-07,10,4831,1,650,1,4159,8,22,1,2345,9,1253,9,3598,California
Plumas,2021-03-08,31,4862,6,656,2,4161,23,45,6,2349,25,1278,29,3627,California
Plumas,2021-03-09,125,4987,2,658,115,4276,8,53,17,2266,108,1386,25,3652,California
Plumas,2021-03-10,199,5186,2,660,195,4471,2,55,75,2219,124,1510,77,3729,California
Plumas,2021-03-11,157,5343,5,665,147,4618,5,60,123,2313,34,1544,128,3857,California
Plumas,2021-03-12,525,5868,3,668,276,4894,246,306,17,2068,508,2052,263,4120,California
Plumas,2021-03-13,21,5889,5,673,4,4898,12,318,3,2066,18,2070,16,4136,California
Plumas,2021-03-14,11,5900,2,675,4,4902,5,323,2,2064,9,2079,7,4143,California
Plumas,2021-03-15,29,5929,1,676,22,4924,6,329,4,2049,25,2104,10,4153,California
Plumas,2021-03-16,28,5957,3,679,24,4948,1,330,18,2058,10,2114,19,4172,California
Plumas,2021-03-17,71,6028,11,690,59,5007,1,331,59,2106,12,2126,60,4232,California
Plumas,2021-03-18,39,6067,3,693,21,5028,15,346,3,2088,36,2162,18,4250,California
Plumas,2021-03-19,123,6190,1,694,121,5149,1,347,117,2202,5,2167,119,4369,California
Stanislaus,2020-12-15,2,2,2,2,0,0,0,0,2,2,0,0,2,2,California
Stanislaus,2020-12-16,38,40,38,40,0,0,0,0,38,40,0,0,38,40,California
Stanislaus,2020-12-17,74,114,74,114,0,0,0,0,74,114,0,0,74,114,California
Stanislaus,2020-12-18,430,544,424,538,6,6,0,0,430,544,0,0,430,544,California
Stanislaus,2020-12-19,193,737,193,731,0,6,0,0,193,737,0,0,193,737,California
Stanislaus,2020-12-20,126,863,126,857,0,6,0,0,126,863,0,0,126,863,California
Stanislaus,2020-12-21,1120,1983,1117,1974,3,9,0,0,1120,1983,0,0,1120,1983,California
Stanislaus,2020-12-22,854,2837,842,2816,12,21,0,0,854,2837,0,0,854,2837,California
Stanislaus,2020-12-23,464,3301,447,3263,17,38,0,0,464,3301,0,0,464,3301,California
Stanislaus,2020-12-24,97,3398,88,3351,9,47,0,0,97,3398,0,0,97,3398,California
Stanislaus,2020-12-26,47,3445,6,3357,41,88,0,0,47,3445,0,0,47,3445,California
Stanislaus,2020-12-27,11,3456,6,3363,5,93,0,0,11,3456,0,0,11,3456,California
Stanislaus,2020-12-28,495,3951,401,3764,94,187,0,0,495,3951,0,0,495,3951,California
Stanislaus,2020-12-29,503,4454,427,4191,76,263,0,0,503,4454,0,0,503,4454,California
Stanislaus,2020-12-30,539,4993,283,4474,256,519,0,0,539,4993,0,0,539,4993,California
Stanislaus,2020-12-31,315,5308,172,4646,143,662,0,0,317,5310,0,0,317,5310,California
Stanislaus,2021-01-01,6,5314,1,4647,5,667,0,0,6,5316,0,0,6,5316,California
Stanislaus,2021-01-02,30,5344,22,4669,8,675,0,0,30,5346,0,0,30,5346,California
Stanislaus,2021-01-03,88,5432,85,4754,3,678,0,0,88,5434,0,0,88,5434,California
Stanislaus,2021-01-04,110,5542,30,4784,80,758,0,0,113,5547,0,0,113,5547,California
Stanislaus,2021-01-05,847,6389,331,5115,516,1274,0,0,822,6352,18,18,823,6370,California
Stanislaus,2021-01-06,976,7365,546,5661,430,1704,0,0,900,7191,66,84,905,7275,California
Stanislaus,2021-01-07,1083,8448,692,6353,391,2095,0,0,960,8058,110,194,977,8252,California
Stanislaus,2021-01-08,1312,9760,754,7107,558,2653,0,0,943,8638,366,560,946,9198,California
Stanislaus,2021-01-09,289,10049,145,7252,144,2797,0,0,197,8743,92,652,197,9395,California
Stanislaus,2021-01-10,45,10094,19,7271,26,2823,0,0,28,8754,17,669,28,9423,California
Stanislaus,2021-01-11,1547,11641,1263,8534,284,3107,0,0,597,8413,947,1616,606,10029,California
Stanislaus,2021-01-12,1481,13122,888,9422,593,3700,0,0,825,8589,652,2268,828,10857,California
Stanislaus,2021-01-13,1439,14561,678,10100,761,4461,0,0,1115,9385,323,2591,1119,11976,California
Stanislaus,2021-01-14,2204,16765,277,10377,1927,6388,0,0,2076,11369,126,2717,2110,14086,California
Stanislaus,2021-01-15,2871,19636,1146,11523,1725,8113,0,0,2728,14030,120,2837,2781,16867,California
Stanislaus,2021-01-16,565,20201,50,11573,515,8628,0,0,553,14574,11,2848,555,17422,California
Stanislaus,2021-01-17,246,20447,203,11776,43,8671,0,0,240,14808,6,2854,240,17662,California
Stanislaus,2021-01-18,2160,22607,1014,12790,1146,9817,0,0,1810,16316,347,3201,1855,19517,California
Stanislaus,2021-01-19,1259,23866,736,13526,523,10340,0,0,800,16661,457,3658,802,20319,California
Stanislaus,2021-01-20,995,24861,479,14005,516,10856,0,0,703,17074,291,3949,704,21023,California
Stanislaus,2021-01-21,3652,28513,2940,16945,712,11568,0,0,3366,20211,285,4234,3422,24445,California
Stanislaus,2021-01-22,1093,29606,305,17250,788,12356,0,0,1050,21221,44,4278,1054,25499,California
Stanislaus,2021-01-23,348,29954,37,17287,311,12667,0,0,298,21469,50,4328,298,25797,California
Stanislaus,2021-01-24,287,30241,99,17386,188,12855,0,0,222,21626,65,4393,222,26019,California
Stanislaus,2021-01-25,3127,33368,218,17604,2909,15764,0,0,2872,24331,254,4647,2959,28978,California
Stanislaus,2021-01-26,1726,35094,730,18334,996,16760,0,0,1315,25257,405,5052,1331,30309,California
Stanislaus,2021-01-27,1812,36906,960,19294,852,17612,0,0,1160,25776,646,5698,1165,31474,California
Stanislaus,2021-01-28,2230,39136,1479,20773,751,18363,0,0,1771,27131,448,6146,1803,33277,California
Stanislaus,2021-01-29,2473,41609,1188,21961,1285,19648,0,0,1966,28663,460,6606,1992,35269,California
Stanislaus,2021-01-30,298,41907,117,22078,181,19829,0,0,246,28858,54,6660,249,35518,California
Stanislaus,2021-01-31,364,42271,312,22390,52,19881,0,0,361,29210,12,6672,364,35882,California
Stanislaus,2021-02-01,1270,43541,539,22929,731,20612,0,0,935,29820,329,7001,939,36821,California
Stanislaus,2021-02-02,1256,44797,367,23296,889,21501,0,0,802,30176,455,7456,811,37632,California
Stanislaus,2021-02-03,2510,47307,1065,24361,1445,22946,0,0,1828,31336,679,8135,1839,39471,California
Stanislaus,2021-02-04,2096,49403,716,25077,1380,24326,0,0,1590,32425,504,8639,1593,41064,California
Stanislaus,2021-02-05,2837,52240,1445,26522,1392,25718,0,0,1614,32862,1187,9826,1624,42688,California
Stanislaus,2021-02-06,1010,53250,287,26809,723,26441,0,0,820,33492,191,10017,821,43509,California
Stanislaus,2021-02-07,208,53458,184,26993,24,26465,0,0,37,33361,170,10187,39,43548,California
Stanislaus,2021-02-08,2021,55479,1303,28296,718,27183,0,0,1122,33608,883,11070,1130,44678,California
Stanislaus,2021-02-09,1870,57349,786,29082,1084,28267,0,0,1100,33951,767,11837,1110,45788,California
Stanislaus,2021-02-10,1975,59324,560,29642,1415,29682,0,0,1060,34120,907,12744,1076,46864,California
Stanislaus,2021-02-11,5495,64819,3382,33024,2113,31795,0,0,1397,31562,3992,16736,1434,48298,California
Stanislaus,2021-02-12,3508,68327,1090,34114,2418,34213,0,0,1651,31414,1826,18562,1678,49976,California
Stanislaus,2021-02-13,1535,69862,752,34866,783,34996,0,0,1092,32065,446,19008,1097,51073,California
Stanislaus,2021-02-14,423,70285,172,35038,251,35247,0,0,356,32358,64,19072,357,51430,California
Stanislaus,2021-02-15,1831,72116,251,35289,1580,36827,0,0,625,31878,1122,20194,642,52072,California
Stanislaus,2021-02-16,1349,73465,400,35689,949,37776,0,0,569,31717,775,20969,614,52686,California
Stanislaus,2021-02-17,2705,76170,1631,37320,1074,38850,0,0,1924,32907,782,21751,1972,54658,California
Stanislaus,2021-02-18,3293,79463,1858,39178,1435,40285,0,0,1722,33325,1525,23276,1943,56601,California
Stanislaus,2021-02-19,2738,82201,1015,40193,1723,42008,0,0,1530,33827,1192,24468,1694,58295,California
Stanislaus,2021-02-20,741,82942,365,40558,376,42384,0,0,479,34052,261,24729,486,58781,California
Stanislaus,2021-02-21,725,83667,515,41073,210,42594,0,0,344,34076,371,25100,395,59176,California
Stanislaus,2021-02-22,2279,85946,1586,42659,693,43287,0,0,1565,34976,691,25791,1591,60767,California
Stanislaus,2021-02-23,3677,89623,672,43331,3005,46292,0,0,1423,35231,2199,27990,2454,63221,California
Stanislaus,2021-02-24,4022,93645,2697,46028,1325,47617,0,0,2834,37271,1178,29168,3218,66439,California
Stanislaus,2021-02-25,3886,97531,2629,48657,1257,48874,0,0,2912,39427,952,30120,3108,69547,California
Stanislaus,2021-02-26,4148,101679,1167,49824,2981,51855,0,0,2556,40899,1495,31615,2967,72514,California
Stanislaus,2021-02-27,2139,103818,658,50482,1480,53335,1,1,1729,42404,388,32003,1893,74407,California
Stanislaus,2021-02-28,752,104570,225,50707,527,53862,0,1,697,43062,49,32052,707,75114,California
Stanislaus,2021-03-01,3026,107596,1577,52284,1449,55311,0,1,1620,43342,1388,33440,1668,76782,California
Stanislaus,2021-03-02,2370,109966,1421,53705,949,56260,0,1,1622,44254,734,34174,1646,78428,California
Stanislaus,2021-03-03,3553,113519,2140,55845,1410,57670,3,4,2703,46146,838,35012,2730,81158,California
Stanislaus,2021-03-04,5452,118971,3167,59012,2267,59937,18,22,4034,49081,1406,36418,4341,85499,California
Stanislaus,2021-03-05,4069,123040,1247,60259,2780,62717,42,64,2870,51063,1190,37608,3172,88671,California
Stanislaus,2021-03-06,3687,126727,2233,62492,1367,64084,87,151,2663,52840,1019,38627,2796,91467,California
Stanislaus,2021-03-07,825,127552,377,62869,412,64496,36,187,636,53330,187,38814,677,92144,California
Stanislaus,2021-03-08,1880,129432,862,63731,962,65458,56,243,1166,53915,710,39524,1295,93439,California
Stanislaus,2021-03-09,2668,132100,987,64718,1593,67051,88,331,1696,54773,955,40479,1813,95252,California
Stanislaus,2021-03-10,5403,137503,2598,67316,2588,69639,217,548,3676,57155,1715,42194,4097,99349,California
Stanislaus,2021-03-11,5925,143428,3274,70590,2202,71841,449,997,3976,60131,1901,44095,4877,104226,California
Stanislaus,2021-03-12,5901,149329,1241,71831,2782,74623,1878,2875,2530,61656,3360,47455,4885,109111,California
Stanislaus,2021-03-13,3528,152857,2179,74010,1286,75909,63,2938,2618,63537,901,48356,2782,111893,California
Stanislaus,2021-03-14,713,153570,444,74454,251,76160,18,2956,351,63580,360,48716,403,112296,California
Stanislaus,2021-03-15,3513,157083,1820,76274,1443,77603,250,3206,1470,63407,2017,50733,1844,114140,California
Stanislaus,2021-03-16,4621,161704,2310,78584,2011,79614,300,3506,3372,65906,1234,51967,3733,117873,California
Stanislaus,2021-03-17,4391,166095,2668,81252,1551,81165,172,3678,2578,66928,1800,53767,2822,120695,California
Stanislaus,2021-03-18,5096,171191,3052,84304,1995,83160,49,3727,2948,68748,2105,55872,3925,124620,California
Stanislaus,2021-03-19,3427,174618,666,84970,1818,84978,943,4670,1817,70183,1600,57472,3035,127655,California
Stanislaus,2021-03-20,1,174619,0,84970,1,84979,0,4670,1,70184,0,57472,1,127656,California
Mendocino,2020-12-17,70,70,70,70,0,0,0,0,70,70,0,0,70,70,California
Mendocino,2020-12-18,86,156,85,155,1,1,0,0,85,155,0,0,85,155,California
Mendocino,2020-12-19,3,159,3,158,0,1,0,0,3,158,0,0,3,158,California
Mendocino,2020-12-20,7,166,7,165,0,1,0,0,7,165,0,0,7,165,California
Mendocino,2020-12-21,245,411,245,410,0,1,0,0,76,241,0,0,76,241,California
Mendocino,2020-12-22,248,659,188,598,60,61,0,0,248,489,0,0,248,489,California
Mendocino,2020-12-23,272,931,48,646,224,285,0,0,271,760,0,0,271,760,California
Mendocino,2020-12-24,49,980,8,654,41,326,0,0,49,809,0,0,49,809,California
Mendocino,2020-12-25,1,981,0,654,1,327,0,0,1,810,0,0,1,810,California
Mendocino,2020-12-26,2,983,2,656,0,327,0,0,2,812,0,0,2,812,California
Mendocino,2020-12-27,1,984,0,656,1,328,0,0,1,813,0,0,1,813,California
Mendocino,2020-12-28,73,1057,8,664,65,393,0,0,73,886,0,0,73,886,California
Mendocino,2020-12-29,120,1177,60,724,60,453,0,0,120,1006,0,0,120,1006,California
Mendocino,2020-12-30,120,1297,66,790,54,507,0,0,120,1126,0,0,120,1126,California
Mendocino,2020-12-31,128,1425,93,883,35,542,0,0,128,1254,0,0,128,1254,California
Mendocino,2021-01-01,2,1427,1,884,1,543,0,0,2,1256,0,0,2,1256,California
Mendocino,2021-01-02,1,1428,1,885,0,543,0,0,1,1257,0,0,1,1257,California
Mendocino,2021-01-04,834,2262,15,900,819,1362,0,0,834,2091,0,0,834,2091,California
Mendocino,2021-01-05,71,2333,35,935,36,1398,0,0,58,2136,13,13,58,2149,California
Mendocino,2021-01-06,149,2482,129,1064,20,1418,0,0,139,2265,10,23,139,2288,California
Mendocino,2021-01-07,355,2837,237,1301,118,1536,0,0,292,2494,63,86,292,2580,California
Mendocino,2021-01-08,94,2931,82,1383,12,1548,0,0,40,2481,54,140,41,2621,California
Mendocino,2021-01-09,8,2939,4,1387,4,1552,0,0,6,2485,2,142,6,2627,California
Mendocino,2021-01-10,8,2947,8,1395,0,1552,0,0,1,2479,7,149,1,2628,California
Mendocino,2021-01-11,99,3046,90,1485,9,1561,0,0,41,2463,57,206,41,2669,California
Mendocino,2021-01-12,386,3432,376,1861,10,1571,0,0,271,2619,115,321,271,2940,California
Mendocino,2021-01-13,478,3910,144,2005,334,1905,0,0,438,3020,38,359,439,3379,California
Mendocino,2021-01-14,626,4536,20,2025,606,2511,0,0,617,3628,9,368,617,3996,California
Mendocino,2021-01-15,1850,6386,858,2883,992,3503,0,0,1845,5469,5,373,1846,5842,California
Mendocino,2021-01-16,778,7164,51,2934,727,4230,0,0,776,6243,2,375,776,6618,California
Mendocino,2021-01-17,552,7716,1,2935,551,4781,0,0,551,6793,1,376,551,7169,California
Mendocino,2021-01-18,487,8203,463,3398,24,4805,0,0,475,7256,12,388,475,7644,California
Mendocino,2021-01-19,327,8530,146,3544,181,4986,0,0,152,7233,175,563,152,7796,California
Mendocino,2021-01-20,548,9078,401,3945,147,5133,0,0,444,7575,102,665,444,8240,California
Mendocino,2021-01-21,524,9602,218,4163,306,5439,0,0,343,7738,180,845,343,8583,California
Mendocino,2021-01-22,147,9749,58,4221,89,5528,0,0,108,7807,39,884,108,8691,California
Mendocino,2021-01-23,155,9904,83,4304,72,5600,0,0,149,7950,6,890,149,8840,California
Mendocino,2021-01-24,4,9908,3,4307,1,5601,0,0,4,7954,0,890,4,8844,California
Mendocino,2021-01-25,186,10094,15,4322,171,5772,0,0,118,8004,68,958,118,8962,California
Mendocino,2021-01-26,154,10248,57,4379,97,5869,0,0,94,8038,60,1018,94,9056,California
Mendocino,2021-01-27,426,10674,358,4737,68,5937,0,0,172,7960,250,1268,172,9228,California
Mendocino,2021-01-28,544,11218,509,5246,35,5972,0,0,458,8332,86,1354,458,9686,California
Mendocino,2021-01-29,387,11605,348,5594,39,6011,0,0,358,8662,29,1383,359,10045,California
Mendocino,2021-01-30,45,11650,27,5621,18,6029,0,0,41,8699,4,1387,41,10086,California
Mendocino,2021-01-31,274,11924,2,5623,272,6301,0,0,3,8431,271,1658,3,10089,California
Mendocino,2021-02-01,365,12289,45,5668,320,6621,0,0,47,8160,318,1976,47,10136,California
Mendocino,2021-02-02,681,12970,498,6166,183,6804,0,0,325,8129,356,2332,325,10461,California
Mendocino,2021-02-03,384,13354,203,6369,181,6985,0,0,218,8183,164,2496,218,10679,California
Mendocino,2021-02-04,581,13935,523,6892,58,7043,0,0,458,8518,123,2619,458,11137,California
Mendocino,2021-02-05,1306,15241,1216,8108,90,7133,0,0,591,8396,713,3332,591,11728,California
Mendocino,2021-02-06,556,15797,155,8263,401,7534,0,0,542,8924,14,3346,542,12270,California
Mendocino,2021-02-07,29,15826,25,8288,4,7538,0,0,29,8953,0,3346,29,12299,California
Mendocino,2021-02-08,742,16568,712,9000,30,7568,0,0,282,8775,460,3806,282,12581,California
Mendocino,2021-02-09,102,16670,57,9057,45,7613,0,0,50,8773,52,3858,50,12631,California
Mendocino,2021-02-10,1467,18137,917,9974,550,8163,0,0,740,8792,721,4579,740,13371,California
Mendocino,2021-02-11,1060,19197,205,10179,855,9018,0,0,230,8192,830,5409,230,13601,California
Mendocino,2021-02-12,979,20176,154,10333,825,9843,0,0,224,7662,754,6163,224,13825,California
Mendocino,2021-02-13,490,20666,12,10345,478,10321,0,0,98,7373,392,6555,103,13928,California
Mendocino,2021-02-14,694,21360,1,10346,693,11014,0,0,136,6951,558,7113,136,14064,California
Mendocino,2021-02-15,202,21562,40,10386,162,11176,0,0,165,7079,37,7150,165,14229,California
Mendocino,2021-02-16,185,21747,48,10434,137,11313,0,0,118,7130,67,7217,118,14347,California
Mendocino,2021-02-17,1339,23086,1179,11613,160,11473,0,0,869,7532,468,7685,870,15217,California
Mendocino,2021-02-18,1064,24150,638,12251,426,11899,0,0,537,7542,527,8212,537,15754,California
Mendocino,2021-02-19,698,24848,146,12397,552,12451,0,0,559,7962,139,8351,559,16313,California
Mendocino,2021-02-20,565,25413,540,12937,25,12476,0,0,537,8473,26,8377,537,16850,California
Mendocino,2021-02-21,18,25431,3,12940,15,12491,0,0,7,8469,11,8388,7,16857,California
Mendocino,2021-02-22,159,25590,30,12970,129,12620,0,0,70,8450,89,8477,70,16927,California
Mendocino,2021-02-23,650,26240,638,13608,12,12632,0,0,603,9007,46,8523,603,17530,California
Mendocino,2021-02-24,1795,28035,1716,15324,79,12711,0,0,1396,10006,397,8920,1396,18926,California
Mendocino,2021-02-25,1217,29252,522,15846,695,13406,0,0,874,10537,343,9263,874,19800,California
Mendocino,2021-02-26,1344,30596,707,16553,637,14043,0,0,987,11169,355,9618,987,20787,California
Mendocino,2021-02-27,191,30787,148,16701,43,14086,0,0,72,11123,118,9736,72,20859,California
Mendocino,2021-02-28,35,30822,16,16717,19,14105,0,0,23,11134,12,9748,23,20882,California
Mendocino,2021-03-01,564,31386,523,17240,41,14146,0,0,531,11632,33,9781,531,21413,California
Mendocino,2021-03-02,63,31449,21,17261,42,14188,0,0,36,11642,26,9807,36,21449,California
Mendocino,2021-03-03,1589,33038,1244,18505,345,14533,0,0,971,11997,616,10423,971,22420,California
Mendocino,2021-03-04,1237,34275,142,18647,1095,15628,0,0,1104,12970,132,10555,1105,23525,California
Mendocino,2021-03-05,166,34441,108,18755,49,15677,9,9,94,13002,71,10626,103,23628,California
Mendocino,2021-03-06,233,34674,12,18767,198,15875,23,32,196,13184,37,10663,219,23847,California
Mendocino,2021-03-07,484,35158,6,18773,458,16333,20,52,103,12925,381,11044,122,23969,California
Mendocino,2021-03-08,111,35269,30,18803,49,16382,32,84,60,12966,51,11095,92,24061,California
Mendocino,2021-03-09,341,35610,201,19004,121,16503,19,103,274,13192,67,11162,293,24354,California
Mendocino,2021-03-10,994,36604,924,19928,63,16566,7,110,268,12746,723,11885,277,24631,California
Mendocino,2021-03-11,708,37312,561,20489,94,16660,53,163,299,12691,407,12292,352,24983,California
Mendocino,2021-03-12,931,38243,673,21162,164,16824,94,257,715,13285,215,12507,809,25792,California
Mendocino,2021-03-13,566,38809,491,21653,26,16850,49,306,82,12933,483,12990,131,25923,California
Mendocino,2021-03-14,63,38872,4,21657,52,16902,7,313,7,12891,56,13046,14,25937,California
Mendocino,2021-03-15,575,39447,34,21691,485,17387,56,369,196,12765,378,13424,252,26189,California
Mendocino,2021-03-16,556,40003,362,22053,152,17539,42,411,140,12532,415,13839,182,26371,California
Mendocino,2021-03-17,1201,41204,1134,23187,40,17579,27,438,188,11747,1012,14851,227,26598,California
Mendocino,2021-03-18,280,41484,136,23323,138,17717,6,444,103,11682,175,15026,110,26708,California
Mendocino,2021-03-19,391,41875,56,23379,313,18030,22,466,61,11435,330,15356,83,26791,California
Calaveras,2020-12-16,5,5,5,5,0,0,0,0,5,5,0,0,5,5,California
Calaveras,2020-12-17,3,8,3,8,0,0,0,0,3,8,0,0,3,8,California
Calaveras,2020-12-18,38,46,38,46,0,0,0,0,38,46,0,0,38,46,California
Calaveras,2020-12-19,3,49,3,49,0,0,0,0,3,49,0,0,3,49,California
Calaveras,2020-12-20,3,52,3,52,0,0,0,0,3,52,0,0,3,52,California
Calaveras,2020-12-21,55,107,48,100,7,7,0,0,55,107,0,0,55,107,California
Calaveras,2020-12-22,81,188,77,177,4,11,0,0,82,189,0,0,82,189,California
Calaveras,2020-12-23,77,265,75,252,2,13,0,0,86,275,0,0,86,275,California
Calaveras,2020-12-24,2,267,2,254,0,13,0,0,2,277,0,0,2,277,California
Calaveras,2020-12-26,3,270,3,257,0,13,0,0,3,280,0,0,3,280,California
Calaveras,2020-12-28,22,292,18,275,4,17,0,0,21,300,1,1,21,301,California
Calaveras,2020-12-29,166,458,148,423,18,35,0,0,166,466,0,1,166,467,California
Calaveras,2020-12-30,94,552,82,505,12,47,0,0,94,560,0,1,94,561,California
Calaveras,2020-12-31,34,586,26,531,8,55,0,0,34,594,0,1,34,595,California
Calaveras,2021-01-02,11,597,11,542,0,55,0,0,11,605,0,1,11,606,California
Calaveras,2021-01-03,8,605,3,545,5,60,0,0,8,613,0,1,8,614,California
Calaveras,2021-01-04,33,638,5,550,28,88,0,0,33,646,0,1,33,647,California
Calaveras,2021-01-05,39,677,9,559,30,118,0,0,38,681,3,4,38,685,California
Calaveras,2021-01-06,109,786,30,589,79,197,0,0,99,770,10,14,99,784,California
Calaveras,2021-01-07,106,892,27,616,79,276,0,0,94,855,11,25,96,880,California
Calaveras,2021-01-08,67,959,37,653,30,306,0,0,45,879,22,47,46,926,California
Calaveras,2021-01-09,6,965,6,659,0,306,0,0,2,877,4,51,2,928,California
Calaveras,2021-01-10,2,967,0,659,2,308,0,0,2,879,0,51,2,930,California
Calaveras,2021-01-11,62,1029,58,717,4,312,0,0,27,872,34,85,27,957,California
Calaveras,2021-01-12,87,1116,54,771,33,345,0,0,53,892,34,119,54,1011,California
Calaveras,2021-01-13,108,1224,44,815,64,409,0,0,75,934,33,152,75,1086,California
Calaveras,2021-01-14,136,1360,41,856,95,504,0,0,101,1001,34,186,101,1187,California
Calaveras,2021-01-15,113,1473,52,908,61,565,0,0,86,1063,26,212,88,1275,California
Calaveras,2021-01-16,13,1486,2,910,11,576,0,0,12,1074,1,213,12,1287,California
Calaveras,2021-01-17,10,1496,1,911,9,585,0,0,10,1084,0,213,10,1297,California
Calaveras,2021-01-18,132,1628,20,931,112,697,0,0,119,1193,13,226,122,1419,California
Calaveras,2021-01-19,199,1827,172,1103,27,724,0,0,58,1113,139,365,59,1478,California
Calaveras,2021-01-20,393,2220,79,1182,314,1038,0,0,309,1346,83,448,316,1794,California
Calaveras,2021-01-21,461,2681,40,1222,421,1459,0,0,434,1759,26,474,439,2233,California
Calaveras,2021-01-22,433,3114,23,1245,410,1869,0,0,424,2180,9,483,430,2663,California
Calaveras,2021-01-23,23,3137,10,1255,13,1882,0,0,19,2195,4,487,19,2682,California
Calaveras,2021-01-24,15,3152,9,1264,6,1888,0,0,13,2206,2,489,13,2695,California
Calaveras,2021-01-25,122,3274,7,1271,115,2003,0,0,117,2318,5,494,117,2812,California
Calaveras,2021-01-26,47,3321,17,1288,30,2033,0,0,37,2345,10,504,37,2849,California
Calaveras,2021-01-27,159,3480,43,1331,116,2149,0,0,132,2451,26,530,132,2981,California
Calaveras,2021-01-28,162,3642,21,1352,141,2290,0,0,140,2572,22,552,143,3124,California
Calaveras,2021-01-29,442,4084,33,1385,409,2699,0,0,422,2981,20,572,429,3553,California
Calaveras,2021-01-30,27,4111,10,1395,17,2716,0,0,26,3007,0,572,26,3579,California
Calaveras,2021-01-31,5,4116,2,1397,3,2719,0,0,4,3010,1,573,4,3583,California
Calaveras,2021-02-01,54,4170,40,1437,14,2733,0,0,35,3026,19,592,35,3618,California
Calaveras,2021-02-02,110,4280,25,1462,85,2818,0,0,71,3058,39,631,71,3689,California
Calaveras,2021-02-03,441,4721,44,1506,397,3215,0,0,356,3331,84,715,357,4046,California
Calaveras,2021-02-04,350,5071,25,1531,325,3540,0,0,296,3575,53,768,297,4343,California
Calaveras,2021-02-05,61,5132,22,1553,39,3579,0,0,40,3594,21,789,40,4383,California
Calaveras,2021-02-06,22,5154,13,1566,9,3588,0,0,22,3616,0,789,22,4405,California
Calaveras,2021-02-07,4,5158,1,1567,3,3591,0,0,2,3616,2,791,2,4407,California
Calaveras,2021-02-08,34,5192,18,1585,16,3607,0,0,26,3636,7,798,27,4434,California
Calaveras,2021-02-09,201,5393,94,1679,107,3714,0,0,138,3717,57,855,138,4572,California
Calaveras,2021-02-10,503,5896,27,1706,476,4190,0,0,437,4089,66,921,438,5010,California
Calaveras,2021-02-11,574,6470,75,1781,499,4689,0,0,471,4459,101,1022,471,5481,California
Calaveras,2021-02-12,560,7030,318,2099,242,4931,0,0,485,4870,75,1097,486,5967,California
Calaveras,2021-02-13,193,7223,37,2136,156,5087,0,0,178,5033,15,1112,178,6145,California
Calaveras,2021-02-14,214,7437,73,2209,141,5228,0,0,200,5219,14,1126,200,6345,California
Calaveras,2021-02-15,370,7807,18,2227,352,5580,0,0,252,5358,115,1241,254,6599,California
Calaveras,2021-02-16,289,8096,169,2396,120,5700,0,0,234,5538,55,1296,235,6834,California
Calaveras,2021-02-17,477,8573,35,2431,442,6142,0,0,205,5478,266,1562,206,7040,California
Calaveras,2021-02-18,489,9062,86,2517,403,6545,0,0,95,5187,387,1949,96,7136,California
Calaveras,2021-02-19,440,9502,42,2559,398,6943,0,0,98,4952,334,2283,99,7235,California
Calaveras,2021-02-20,55,9557,15,2574,40,6983,0,0,43,4983,12,2295,43,7278,California
Calaveras,2021-02-21,20,9577,11,2585,9,6992,0,0,17,4997,3,2298,17,7295,California
Calaveras,2021-02-22,64,9641,39,2624,25,7017,0,0,34,5001,30,2328,34,7329,California
Calaveras,2021-02-23,147,9788,67,2691,80,7097,0,0,99,5054,48,2376,101,7430,California
Calaveras,2021-02-24,91,9879,44,2735,47,7144,0,0,64,5092,27,2403,65,7495,California
Calaveras,2021-02-25,472,10351,99,2834,373,7517,0,0,320,5263,149,2552,320,7815,California
Calaveras,2021-02-26,639,10990,42,2876,597,8114,0,0,339,5316,287,2839,340,8155,California
Calaveras,2021-02-27,203,11193,20,2896,183,8297,0,0,179,5471,24,2863,179,8334,California
Calaveras,2021-02-28,87,11280,13,2909,74,8371,0,0,81,5547,6,2869,82,8416,California
Calaveras,2021-03-01,185,11465,59,2968,126,8497,0,0,139,5641,45,2914,139,8555,California
Calaveras,2021-03-02,233,11698,87,3055,146,8643,0,0,192,5794,39,2953,192,8747,California
Calaveras,2021-03-03,478,12176,95,3150,383,9026,0,0,185,5701,285,3238,192,8939,California
Calaveras,2021-03-04,532,12708,60,3210,472,9498,0,0,245,5664,284,3522,247,9186,California
Calaveras,2021-03-05,442,13150,265,3475,172,9670,5,5,122,5484,318,3840,138,9324,California
Calaveras,2021-03-06,132,13282,40,3515,86,9756,6,11,99,5557,33,3873,106,9430,California
Calaveras,2021-03-07,73,13355,33,3548,32,9788,8,19,28,5549,44,3917,36,9466,California
Calaveras,2021-03-08,92,13447,18,3566,68,9856,6,25,67,5598,25,3942,74,9540,California
Calaveras,2021-03-09,359,13806,147,3713,207,10063,5,30,41,5331,315,4257,48,9588,California
Calaveras,2021-03-10,397,14203,28,3741,367,10430,2,32,36,5011,360,4617,40,9628,California
Calaveras,2021-03-11,816,15019,390,4131,416,10846,10,42,391,4991,424,5041,404,10032,California
Calaveras,2021-03-12,344,15363,212,4343,124,10970,8,50,222,5147,122,5163,278,10310,California
Calaveras,2021-03-13,87,15450,16,4359,66,11036,5,55,24,5145,63,5226,61,10371,California
Calaveras,2021-03-14,86,15536,10,4369,75,11111,1,56,10,5085,76,5302,16,10387,California
Calaveras,2021-03-15,322,15858,45,4414,256,11367,21,77,51,4889,269,5571,73,10460,California
Calaveras,2021-03-16,648,16506,517,4931,119,11486,12,89,509,5274,138,5709,523,10983,California
Calaveras,2021-03-17,265,16771,43,4974,211,11697,11,100,41,5106,223,5932,55,11038,California
Calaveras,2021-03-18,529,17300,466,5440,49,11746,14,114,443,5483,86,6018,463,11501,California
Calaveras,2021-03-19,147,17447,15,5455,86,11832,46,160,26,5437,119,6137,73,11574,California
El Dorado,2020-12-15,12,12,12,12,0,0,0,0,12,12,0,0,12,12,California
El Dorado,2020-12-16,40,52,40,52,0,0,0,0,40,52,0,0,40,52,California
El Dorado,2020-12-17,31,83,31,83,0,0,0,0,31,83,0,0,31,83,California
El Dorado,2020-12-18,235,318,235,318,0,0,0,0,235,318,0,0,235,318,California
El Dorado,2020-12-19,116,434,116,434,0,0,0,0,116,434,0,0,116,434,California
El Dorado,2020-12-20,84,518,84,518,0,0,0,0,84,518,0,0,84,518,California
El Dorado,2020-12-21,304,822,303,821,1,1,0,0,304,822,0,0,304,822,California
El Dorado,2020-12-22,239,1061,215,1036,24,25,0,0,239,1061,0,0,239,1061,California
El Dorado,2020-12-23,189,1250,139,1175,50,75,0,0,189,1250,0,0,189,1250,California
El Dorado,2020-12-24,87,1337,65,1240,22,97,0,0,87,1337,0,0,87,1337,California
El Dorado,2020-12-25,8,1345,8,1248,0,97,0,0,8,1345,0,0,8,1345,California
El Dorado,2020-12-26,43,1388,25,1273,18,115,0,0,43,1388,0,0,43,1388,California
El Dorado,2020-12-27,37,1425,33,1306,4,119,0,0,37,1425,0,0,37,1425,California
El Dorado,2020-12-28,215,1640,170,1476,45,164,0,0,215,1640,0,0,215,1640,California
El Dorado,2020-12-29,450,2090,138,1614,312,476,0,0,450,2090,0,0,450,2090,California
El Dorado,2020-12-30,502,2592,135,1749,367,843,0,0,502,2592,0,0,502,2592,California
El Dorado,2020-12-31,108,2700,68,1817,40,883,0,0,108,2700,0,0,108,2700,California
El Dorado,2021-01-01,4,2704,3,1820,1,884,0,0,4,2704,0,0,4,2704,California
El Dorado,2021-01-02,148,2852,137,1957,11,895,0,0,148,2852,0,0,148,2852,California
El Dorado,2021-01-03,89,2941,16,1973,73,968,0,0,89,2941,0,0,89,2941,California
El Dorado,2021-01-04,190,3131,62,2035,128,1096,0,0,190,3131,0,0,190,3131,California
El Dorado,2021-01-05,200,3331,46,2081,154,1250,0,0,184,3299,16,16,184,3315,California
El Dorado,2021-01-06,259,3590,187,2268,72,1322,0,0,196,3432,63,79,196,3511,California
El Dorado,2021-01-07,326,3916,134,2402,192,1514,0,0,255,3617,71,150,256,3767,California
El Dorado,2021-01-08,969,4885,500,2902,469,1983,0,0,767,4183,202,352,768,4535,California
El Dorado,2021-01-09,191,5076,155,3057,36,2019,0,0,123,4238,68,420,123,4658,California
El Dorado,2021-01-10,180,5256,129,3186,51,2070,0,0,111,4280,69,489,111,4769,California
El Dorado,2021-01-11,649,5905,290,3476,359,2429,0,0,454,4540,194,683,454,5223,California
El Dorado,2021-01-12,687,6592,419,3895,268,2697,0,0,439,4731,248,931,439,5662,California
El Dorado,2021-01-13,691,7283,295,4190,396,3093,0,0,532,5105,159,1090,533,6195,California
El Dorado,2021-01-14,669,7952,218,4408,451,3544,0,0,573,5582,96,1186,573,6768,California
El Dorado,2021-01-15,663,8615,180,4588,483,4027,0,0,591,6101,72,1258,591,7359,California
El Dorado,2021-01-16,171,8786,104,4692,67,4094,0,0,144,6218,27,1285,144,7503,California
El Dorado,2021-01-17,96,8882,44,4736,52,4146,0,0,80,6282,16,1301,80,7583,California
El Dorado,2021-01-18,415,9297,138,4874,277,4423,0,0,347,6561,68,1369,347,7930,California
El Dorado,2021-01-19,631,9928,342,5216,289,4712,0,0,483,6896,148,1517,483,8413,California
El Dorado,2021-01-20,1004,10932,682,5898,322,5034,0,0,892,7677,111,1628,892,9305,California
El Dorado,2021-01-21,1137,12069,558,6456,579,5613,0,0,932,8447,162,1790,932,10237,California
El Dorado,2021-01-22,1088,13157,703,7159,385,5998,0,0,1038,9436,49,1839,1038,11275,California
El Dorado,2021-01-23,732,13889,614,7773,118,6116,0,0,622,9948,110,1949,622,11897,California
El Dorado,2021-01-24,125,14014,75,7848,50,6166,0,0,107,10037,18,1967,107,12004,California
El Dorado,2021-01-25,597,14611,194,8042,403,6569,0,0,510,10460,87,2054,510,12514,California
El Dorado,2021-01-26,664,15275,357,8399,307,6876,0,0,566,10929,98,2152,567,13081,California
El Dorado,2021-01-27,916,16191,323,8722,593,7469,0,0,584,11180,333,2485,584,13665,California
El Dorado,2021-01-28,1088,17279,449,9171,639,8108,0,0,732,11556,356,2841,732,14397,California
El Dorado,2021-01-29,946,18225,486,9657,460,8568,0,0,720,12051,225,3066,720,15117,California
El Dorado,2021-01-30,605,18830,354,10011,251,8819,0,0,448,12342,157,3223,448,15565,California
El Dorado,2021-01-31,206,19036,184,10195,22,8841,0,0,176,12488,30,3253,176,15741,California
El Dorado,2021-02-01,782,19818,366,10561,416,9257,0,0,641,12989,140,3393,641,16382,California
El Dorado,2021-02-02,813,20631,363,10924,450,9707,0,0,661,13498,152,3545,661,17043,California
El Dorado,2021-02-03,860,21491,472,11396,388,10095,0,0,651,13940,209,3754,651,17694,California
El Dorado,2021-02-04,1233,22724,719,12115,514,10609,0,0,840,14390,393,4147,843,18537,California
El Dorado,2021-02-05,1428,24152,589,12704,839,11448,0,0,839,14672,557,4704,839,19376,California
El Dorado,2021-02-06,638,24790,332,13036,306,11754,0,0,531,15097,107,4811,532,19908,California
El Dorado,2021-02-07,246,25036,167,13203,79,11833,0,0,181,15213,65,4876,181,20089,California
El Dorado,2021-02-08,848,25884,407,13610,441,12274,0,0,585,15535,263,5139,585,20674,California
El Dorado,2021-02-09,876,26760,480,14090,396,12670,0,0,464,15587,412,5551,464,21138,California
El Dorado,2021-02-10,1171,27931,722,14812,449,13119,0,0,590,15598,580,6131,591,21729,California
El Dorado,2021-02-11,2003,29934,842,15654,1161,14280,0,0,886,15369,1116,7247,887,22616,California
El Dorado,2021-02-12,1457,31391,810,16464,647,14927,0,0,644,15200,813,8060,644,23260,California
El Dorado,2021-02-13,955,32346,666,17130,289,15216,0,0,416,15080,536,8596,416,23676,California
El Dorado,2021-02-14,467,32813,149,17279,318,15534,0,0,386,15385,81,8677,386,24062,California
El Dorado,2021-02-15,1123,33936,387,17666,736,16270,0,0,779,15820,344,9021,779,24841,California
El Dorado,2021-02-16,1137,35073,522,18188,615,16885,0,0,635,15954,502,9523,636,25477,California
El Dorado,2021-02-17,817,35890,358,18546,459,17344,0,0,376,15894,441,9964,381,25858,California
El Dorado,2021-02-18,1927,37817,927,19473,1000,18344,0,0,1221,16411,706,10670,1223,27081,California
El Dorado,2021-02-19,1056,38873,518,19991,538,18882,0,0,569,16496,487,11157,572,27653,California
El Dorado,2021-02-20,884,39757,412,20403,472,19354,0,0,652,16921,227,11384,652,28305,California
El Dorado,2021-02-21,230,39987,181,20584,49,19403,0,0,90,16872,140,11524,91,28396,California
El Dorado,2021-02-22,823,40810,415,20999,408,19811,0,0,250,16552,572,12096,252,28648,California
El Dorado,2021-02-23,718,41528,451,21450,267,20078,0,0,298,16432,420,12516,300,28948,California
El Dorado,2021-02-24,869,42397,419,21869,450,20528,0,0,342,16247,527,13043,342,29290,California
El Dorado,2021-02-25,1420,43817,813,22682,607,21135,0,0,581,15999,832,13875,584,29874,California
El Dorado,2021-02-26,2017,45834,1318,24000,699,21834,0,0,1365,16713,651,14526,1365,31239,California
El Dorado,2021-02-27,1565,47399,384,24384,1181,23015,0,0,1141,17434,420,14946,1141,32380,California
El Dorado,2021-02-28,510,47909,183,24567,327,23342,0,0,373,17671,137,15083,374,32754,California
El Dorado,2021-03-01,1024,48933,425,24992,599,23941,0,0,543,17738,479,15562,546,33300,California
El Dorado,2021-03-02,819,49752,244,25236,575,24516,0,0,423,17768,394,15956,424,33724,California
El Dorado,2021-03-03,1307,51059,399,25635,908,25424,0,0,884,18234,418,16374,884,34608,California
El Dorado,2021-03-04,2107,53166,1334,26969,773,26197,0,0,949,18031,1155,17529,952,35560,California
El Dorado,2021-03-05,1103,54269,256,27225,842,27039,5,5,646,18230,453,17982,652,36212,California
El Dorado,2021-03-06,601,54870,189,27414,382,27421,30,35,314,18287,287,18269,344,36556,California
El Dorado,2021-03-07,398,55268,198,27612,179,27600,21,56,238,18388,158,18427,259,36815,California
El Dorado,2021-03-08,1114,56382,356,27968,695,28295,63,119,705,18749,409,18836,770,37585,California
El Dorado,2021-03-09,862,57244,215,28183,596,28891,51,170,542,19025,318,19154,594,38179,California
El Dorado,2021-03-10,761,58005,331,28514,408,29299,22,192,467,19221,293,19447,489,38668,California
El Dorado,2021-03-11,2770,60775,1781,30295,821,30120,168,360,1314,19256,1450,20897,1485,40153,California
El Dorado,2021-03-12,1435,62210,599,30894,605,30725,231,591,592,19248,839,21736,831,40984,California
El Dorado,2021-03-13,915,63125,341,31235,320,31045,254,845,339,19264,575,22311,591,41575,California
El Dorado,2021-03-14,645,63770,191,31426,350,31395,104,949,247,19219,398,22709,353,41928,California
El Dorado,2021-03-15,1257,65027,296,31722,838,32233,123,1072,524,19137,732,23441,650,42578,California
El Dorado,2021-03-16,1095,66122,382,32104,574,32807,139,1211,486,19157,605,24046,625,43203,California
El Dorado,2021-03-17,809,66931,265,32369,466,33273,78,1289,500,19426,309,24355,578,43781,California
El Dorado,2021-03-18,1264,68195,800,33169,455,33728,9,1298,863,19898,400,24755,872,44653,California
El Dorado,2021-03-19,282,68477,111,33280,122,33850,49,1347,166,19998,116,24871,216,44869,California
Humboldt,2020-12-15,2,2,2,2,0,0,0,0,2,2,0,0,2,2,California
Humboldt,2020-12-16,15,17,15,17,0,0,0,0,15,17,0,0,15,17,California
Humboldt,2020-12-17,115,132,115,132,0,0,0,0,115,132,0,0,115,132,California
Humboldt,2020-12-18,171,303,171,303,0,0,0,0,171,303,0,0,171,303,California
Humboldt,2020-12-19,10,313,10,313,0,0,0,0,10,313,0,0,10,313,California
Humboldt,2020-12-20,28,341,28,341,0,0,0,0,28,341,0,0,28,341,California
Humboldt,2020-12-21,165,506,165,506,0,0,0,0,165,506,0,0,165,506,California
Humboldt,2020-12-22,286,792,286,792,0,0,0,0,286,792,0,0,286,792,California
Humboldt,2020-12-23,301,1093,253,1045,48,48,0,0,302,1094,0,0,302,1094,California
Humboldt,2020-12-24,24,1117,1,1046,23,71,0,0,24,1118,0,0,24,1118,California
Humboldt,2020-12-25,1,1118,1,1047,0,71,0,0,1,1119,0,0,1,1119,California
Humboldt,2020-12-26,7,1125,6,1053,1,72,0,0,7,1126,0,0,7,1126,California
Humboldt,2020-12-27,1,1126,0,1053,1,73,0,0,1,1127,0,0,1,1127,California
Humboldt,2020-12-28,151,1277,142,1195,9,82,0,0,151,1278,0,0,151,1278,California
Humboldt,2020-12-29,163,1440,121,1316,42,124,0,0,163,1441,0,0,163,1441,California
Humboldt,2020-12-30,220,1660,122,1438,98,222,0,0,220,1661,0,0,220,1661,California
Humboldt,2020-12-31,242,1902,80,1518,162,384,0,0,242,1903,0,0,242,1903,California
Humboldt,2021-01-02,38,1940,1,1519,37,421,0,0,38,1941,0,0,38,1941,California
Humboldt,2021-01-04,214,2154,141,1660,73,494,0,0,215,2156,0,0,215,2156,California
Humboldt,2021-01-05,125,2279,17,1677,108,602,0,0,125,2281,0,0,125,2281,California
Humboldt,2021-01-06,296,2575,199,1876,97,699,0,0,225,2446,60,60,225,2506,California
Humboldt,2021-01-07,384,2959,272,2148,112,811,0,0,301,2666,81,141,301,2807,California
Humboldt,2021-01-08,416,3375,278,2426,138,949,0,0,284,2822,128,269,284,3091,California
Humboldt,2021-01-09,69,3444,45,2471,24,973,0,0,66,2886,3,272,67,3158,California
Humboldt,2021-01-10,84,3528,84,2555,0,973,0,0,4,2810,80,352,4,3162,California
Humboldt,2021-01-11,285,3813,274,2829,11,984,0,0,76,2681,205,557,76,3238,California
Humboldt,2021-01-12,477,4290,314,3143,163,1147,0,0,301,2828,154,711,301,3539,California
Humboldt,2021-01-13,473,4763,271,3414,202,1349,0,0,297,2953,173,884,298,3837,California
Humboldt,2021-01-14,515,5278,161,3575,354,1703,0,0,459,3357,56,940,460,4297,California
Humboldt,2021-01-15,371,5649,40,3615,331,2034,0,0,354,3695,16,956,354,4651,California
Humboldt,2021-01-16,167,5816,5,3620,162,2196,0,0,166,3860,1,957,166,4817,California
Humboldt,2021-01-17,4,5820,3,3623,1,2197,0,0,4,3864,0,957,4,4821,California
Humboldt,2021-01-18,271,6091,235,3858,36,2233,0,0,124,3841,147,1104,124,4945,California
Humboldt,2021-01-19,608,6699,363,4221,245,2478,0,0,482,4203,120,1224,482,5427,California
Humboldt,2021-01-20,814,7513,303,4524,511,2989,0,0,703,4797,110,1334,704,6131,California
Humboldt,2021-01-21,957,8470,261,4785,696,3685,0,0,918,5675,40,1374,918,7049,California
Humboldt,2021-01-22,676,9146,377,5162,299,3984,0,0,668,6335,8,1382,668,7717,California
Humboldt,2021-01-23,612,9758,245,5407,367,4351,0,0,608,6940,4,1386,609,8326,California
Humboldt,2021-01-24,222,9980,1,5408,221,4572,0,0,222,7162,0,1386,222,8548,California
Humboldt,2021-01-25,296,10276,226,5634,70,4642,0,0,143,7152,153,1539,143,8691,California
Humboldt,2021-01-26,513,10789,132,5766,381,5023,0,0,470,7579,43,1582,470,9161,California
Humboldt,2021-01-27,1250,12039,584,6350,666,5689,0,0,1187,8709,57,1639,1187,10348,California
Humboldt,2021-01-28,1440,13479,620,6970,820,6509,0,0,1310,9894,127,1766,1312,11660,California
Humboldt,2021-01-29,1121,14600,539,7509,582,7091,0,0,710,10193,411,2177,710,12370,California
Humboldt,2021-01-30,955,15555,447,7956,508,7599,0,0,947,11132,8,2185,947,13317,California
Humboldt,2021-01-31,307,15862,304,8260,3,7602,0,0,305,11435,2,2187,305,13622,California
Humboldt,2021-02-01,314,16176,174,8434,140,7742,0,0,179,11479,135,2322,179,13801,California
Humboldt,2021-02-02,415,16591,50,8484,365,8107,0,0,320,11706,95,2417,322,14123,California
Humboldt,2021-02-03,629,17220,256,8740,373,8480,0,0,481,12039,148,2565,481,14604,California
Humboldt,2021-02-04,632,17852,260,9000,372,8852,0,0,438,12285,192,2757,438,15042,California
Humboldt,2021-02-05,810,18662,96,9096,714,9566,0,0,629,12733,181,2938,629,15671,California
Humboldt,2021-02-06,907,19569,299,9395,608,10174,0,0,889,13606,16,2954,889,16560,California
Humboldt,2021-02-07,378,19947,7,9402,371,10545,0,0,375,13978,3,2957,375,16935,California
Humboldt,2021-02-08,288,20235,108,9510,180,10725,0,0,169,14029,118,3075,169,17104,California
Humboldt,2021-02-09,383,20618,112,9622,271,10996,0,0,168,13982,215,3290,168,17272,California
Humboldt,2021-02-10,489,21107,300,9922,189,11185,0,0,228,13954,256,3546,228,17500,California
Humboldt,2021-02-11,1270,22377,380,10302,890,12075,0,0,497,13680,771,4317,497,17997,California
Humboldt,2021-02-12,1121,23498,729,11031,392,12467,0,0,691,13941,430,4747,691,18688,California
Humboldt,2021-02-13,1408,24906,467,11498,941,13408,0,0,844,14225,561,5308,845,19533,California
Humboldt,2021-02-14,112,25018,5,11503,107,13515,0,0,111,14335,1,5309,111,19644,California
Humboldt,2021-02-15,286,25304,73,11576,213,13728,0,0,196,14442,90,5399,197,19841,California
Humboldt,2021-02-16,508,25812,102,11678,406,14134,0,0,239,14413,269,5668,240,20081,California
Humboldt,2021-02-17,438,26250,271,11949,167,14301,0,0,136,14247,302,5970,136,20217,California
Humboldt,2021-02-18,964,27214,598,12547,366,14667,0,0,228,13740,735,6705,228,20445,California
Humboldt,2021-02-19,471,27685,433,12980,38,14705,0,0,87,13444,383,7088,87,20532,California
Humboldt,2021-02-20,1270,28955,821,13801,449,15154,0,0,348,12871,921,8009,348,20880,California
Humboldt,2021-02-21,474,29429,469,14270,5,15159,0,0,193,12783,281,8290,193,21073,California
Humboldt,2021-02-22,102,29531,71,14341,31,15190,0,0,26,12735,74,8364,26,21099,California
Humboldt,2021-02-23,150,29681,53,14394,97,15287,0,0,40,12666,109,8473,40,21139,California
Humboldt,2021-02-24,1140,30821,683,15077,457,15744,0,0,571,12669,568,9041,571,21710,California
Humboldt,2021-02-25,824,31645,321,15398,503,16247,0,0,229,12305,593,9634,229,21939,California
Humboldt,2021-02-26,2086,33731,103,15501,1983,18230,0,0,437,11098,1644,11278,437,22376,California
Humboldt,2021-02-27,1154,34885,652,16153,502,18732,0,0,741,11428,412,11690,742,23118,California
Humboldt,2021-02-28,106,34991,13,16166,93,18825,0,0,100,11522,6,11696,100,23218,California
Humboldt,2021-03-01,234,35225,44,16210,190,19015,0,0,162,11612,72,11768,162,23380,California
Humboldt,2021-03-02,250,35475,31,16241,219,19234,0,0,142,11646,108,11876,142,23522,California
Humboldt,2021-03-03,1436,36911,977,17218,459,19693,0,0,1052,12321,378,12254,1053,24575,California
Humboldt,2021-03-04,841,37752,99,17317,742,20435,0,0,258,11997,583,12837,259,24834,California
Humboldt,2021-03-05,868,38620,132,17449,726,21161,10,10,319,11780,546,13383,329,25163,California
Humboldt,2021-03-06,1515,40135,668,18117,798,21959,49,59,653,11623,861,14244,704,25867,California
Humboldt,2021-03-07,352,40487,297,18414,41,22000,14,73,152,11590,199,14443,166,26033,California
Humboldt,2021-03-08,176,40663,17,18431,97,22097,62,135,100,11676,76,14519,162,26195,California
Humboldt,2021-03-09,410,41073,190,18621,105,22202,115,250,204,11790,205,14724,319,26514,California
Humboldt,2021-03-10,598,41671,423,19044,67,22269,108,358,378,12058,219,14943,487,27001,California
Humboldt,2021-03-11,1247,42918,401,19445,753,23022,93,451,478,11861,767,15710,570,27571,California
Humboldt,2021-03-12,1501,44419,959,20404,345,23367,197,648,935,12438,559,16269,1136,28707,California
Humboldt,2021-03-13,1244,45663,808,21212,393,23760,43,691,554,12349,686,16955,597,29304,California
Humboldt,2021-03-14,91,45754,16,21228,68,23828,7,698,22,12309,69,17024,29,29333,California
Humboldt,2021-03-15,274,46028,50,21278,203,24031,21,719,58,12172,216,17240,79,29412,California
Humboldt,2021-03-16,619,46647,205,21483,169,24200,245,964,271,12339,348,17588,515,29927,California
Humboldt,2021-03-17,609,47256,328,21811,189,24389,92,1056,297,12417,311,17899,389,30316,California
Humboldt,2021-03-18,903,48159,632,22443,256,24645,15,1071,520,12573,380,18279,536,30852,California
Humboldt,2021-03-19,400,48559,21,22464,285,24930,94,1165,173,12616,226,18505,269,31121,California
Sierra,2020-12-18,1,1,1,1,0,0,0,0,1,1,0,0,1,1,California
Sierra,2020-12-21,2,3,2,3,0,0,0,0,2,3,0,0,2,3,California
Sierra,2020-12-22,12,15,12,15,0,0,0,0,12,15,0,0,12,15,California
Sierra,2020-12-23,4,19,4,19,0,0,0,0,4,19,0,0,4,19,California
Sierra,2020-12-28,1,20,0,19,1,1,0,0,1,20,0,0,1,20,California
Sierra,2020-12-29,49,69,7,26,42,43,0,0,49,69,0,0,49,69,California
Sierra,2020-12-30,2,71,0,26,2,45,0,0,2,71,0,0,2,71,California
Sierra,2020-12-31,12,83,0,26,12,57,0,0,12,83,0,0,12,83,California
Sierra,2021-01-05,67,150,3,29,64,121,0,0,67,150,0,0,67,150,California
Sierra,2021-01-06,1,151,1,30,0,121,0,0,1,151,0,0,1,151,California
Sierra,2021-01-07,20,171,1,31,19,140,0,0,19,169,1,1,19,170,California
Sierra,2021-01-08,1,172,1,32,0,140,0,0,1,170,0,1,1,171,California
Sierra,2021-01-11,3,175,3,35,0,140,0,0,0,167,3,4,0,171,California
Sierra,2021-01-12,40,215,12,47,28,168,0,0,28,183,12,16,28,199,California
Sierra,2021-01-13,4,219,3,50,1,169,0,0,1,181,3,19,1,200,California
Sierra,2021-01-14,35,254,2,52,33,202,0,0,35,216,0,19,35,235,California
Sierra,2021-01-15,2,256,1,53,1,203,0,0,2,218,0,19,2,237,California
Sierra,2021-01-18,2,258,0,53,2,205,0,0,2,220,0,19,2,239,California
Sierra,2021-01-19,33,291,0,53,33,238,0,0,33,253,0,19,33,272,California
Sierra,2021-01-20,1,292,1,54,0,238,0,0,1,254,0,19,1,273,California
Sierra,2021-01-21,55,347,0,54,55,293,0,0,55,309,0,19,55,328,California
Sierra,2021-01-22,1,348,0,54,1,294,0,0,1,310,0,19,1,329,California
Sierra,2021-01-23,2,350,0,54,2,296,0,0,2,312,0,19,2,331,California
Sierra,2021-01-26,64,414,1,55,63,359,0,0,26,300,38,57,26,357,California
Sierra,2021-01-27,4,418,4,59,0,359,0,0,0,296,4,61,0,357,California
Sierra,2021-01-28,53,471,0,59,53,412,0,0,44,331,9,70,44,401,California
Sierra,2021-01-29,1,472,0,59,1,413,0,0,1,332,0,70,1,402,California
Sierra,2021-01-30,3,475,3,62,0,413,0,0,2,333,1,71,2,404,California
Sierra,2021-02-01,1,476,0,62,1,414,0,0,0,332,1,72,0,404,California
Sierra,2021-02-02,58,534,0,62,58,472,0,0,18,310,40,112,18,422,California
Sierra,2021-02-03,6,540,5,67,1,473,0,0,5,314,1,113,5,427,California
Sierra,2021-02-04,106,646,6,73,100,573,0,0,57,322,49,162,57,484,California
Sierra,2021-02-05,5,651,3,76,2,575,0,0,4,325,1,163,4,488,California
Sierra,2021-02-09,54,705,1,77,53,628,0,0,52,375,2,165,52,540,California
Sierra,2021-02-10,5,710,2,79,3,631,0,0,4,378,1,166,4,544,California
Sierra,2021-02-11,198,908,1,80,197,828,0,0,135,450,63,229,135,679,California
Sierra,2021-02-12,20,928,0,80,20,848,0,0,20,470,0,229,20,699,California
Sierra,2021-02-14,1,929,0,80,1,849,0,0,1,471,0,229,1,700,California
Sierra,2021-02-15,1,930,1,81,0,849,0,0,0,470,1,230,0,700,California
Sierra,2021-02-16,44,974,0,81,44,893,0,0,10,446,34,264,10,710,California
Sierra,2021-02-17,3,977,0,81,3,896,0,0,1,445,2,266,1,711,California
Sierra,2021-02-18,146,1123,0,81,146,1042,0,0,94,487,52,318,94,805,California
Sierra,2021-02-19,1,1124,1,82,0,1042,0,0,1,488,0,318,1,806,California
Sierra,2021-02-20,2,1126,2,84,0,1042,0,0,0,486,2,320,0,806,California
Sierra,2021-02-22,2,1128,2,86,0,1042,0,0,1,486,1,321,1,807,California
Sierra,2021-02-23,4,1132,0,86,4,1046,0,0,4,490,0,321,4,811,California
Sierra,2021-02-24,2,1134,1,87,1,1047,0,0,1,490,1,322,1,812,California
Sierra,2021-02-25,127,1261,1,88,126,1173,0,0,59,482,67,389,59,871,California
Sierra,2021-02-26,9,1270,6,94,3,1176,0,0,4,481,5,394,4,875,California
Sierra,2021-02-27,2,1272,2,96,0,1176,0,0,0,479,2,396,0,875,California
Sierra,2021-03-01,2,1274,1,97,1,1177,0,0,1,479,1,397,1,876,California
Sierra,2021-03-02,51,1325,0,97,51,1228,0,0,32,492,19,416,32,908,California
Sierra,2021-03-03,2,1327,2,99,0,1228,0,0,1,492,1,417,1,909,California
Sierra,2021-03-04,100,1427,2,101,98,1326,0,0,49,490,51,468,49,958,California
Sierra,2021-03-05,12,1439,0,101,12,1338,0,0,10,498,2,470,10,968,California
Sierra,2021-03-08,3,1442,2,103,0,1338,1,1,2,500,1,471,3,971,California
Sierra,2021-03-09,54,1496,1,104,53,1391,0,1,11,468,43,514,11,982,California
Sierra,2021-03-10,4,1500,0,104,4,1395,0,1,2,468,2,516,2,984,California
Sierra,2021-03-11,148,1648,0,104,148,1543,0,1,27,374,121,637,27,1011,California
Sierra,2021-03-12,20,1668,1,105,19,1562,0,1,0,354,20,657,0,1011,California
Sierra,2021-03-13,13,1681,0,105,13,1575,0,1,13,367,0,657,13,1024,California
Sierra,2021-03-14,1,1682,1,106,0,1575,0,1,0,366,1,658,0,1024,California
Sierra,2021-03-15,2,1684,1,107,1,1576,0,1,1,366,1,659,1,1025,California
Sierra,2021-03-16,22,1706,1,108,20,1596,1,2,10,365,12,671,11,1036,California
Sierra,2021-03-17,2,1708,0,108,2,1598,0,2,0,363,2,673,0,1036,California
Sierra,2021-03-18,122,1830,0,108,121,1719,1,3,35,313,86,759,36,1072,California
Sierra,2021-03-19,1,1831,1,109,0,1719,0,3,1,314,0,759,1,1073,California
San Francisco,2020-12-15,8,8,8,8,0,0,0,0,8,8,0,0,8,8,California
San Francisco,2020-12-16,229,237,229,237,0,0,0,0,229,237,0,0,229,237,California
San Francisco,2020-12-17,397,634,397,634,0,0,0,0,397,634,0,0,397,634,California
San Francisco,2020-12-18,884,1518,884,1518,0,0,0,0,884,1518,0,0,884,1518,California
San Francisco,2020-12-19,600,2118,600,2118,0,0,0,0,600,2118,0,0,600,2118,California
San Francisco,2020-12-20,484,2602,484,2602,0,0,0,0,484,2602,0,0,484,2602,California
San Francisco,2020-12-21,1159,3761,1159,3761,0,0,0,0,1159,3761,0,0,1159,3761,California
San Francisco,2020-12-22,1400,5161,1366,5127,34,34,0,0,1400,5161,0,0,1400,5161,California
San Francisco,2020-12-23,1308,6469,1021,6148,287,321,0,0,1308,6469,0,0,1308,6469,California
San Francisco,2020-12-24,836,7305,503,6651,333,654,0,0,836,7305,0,0,836,7305,California
San Francisco,2020-12-25,30,7335,25,6676,5,659,0,0,30,7335,0,0,30,7335,California
San Francisco,2020-12-26,241,7576,148,6824,93,752,0,0,241,7576,0,0,241,7576,California
San Francisco,2020-12-27,273,7849,60,6884,213,965,0,0,273,7849,0,0,273,7849,California
San Francisco,2020-12-28,1263,9112,679,7563,584,1549,0,0,1263,9112,0,0,1263,9112,California
San Francisco,2020-12-29,1245,10357,620,8183,625,2174,0,0,1245,10357,0,0,1245,10357,California
San Francisco,2020-12-30,1470,11827,769,8952,701,2875,0,0,1470,11827,0,0,1470,11827,California
San Francisco,2020-12-31,959,12786,408,9360,551,3426,0,0,959,12786,0,0,959,12786,California
San Francisco,2021-01-01,64,12850,58,9418,6,3432,0,0,64,12850,0,0,64,12850,California
San Francisco,2021-01-02,329,13179,297,9715,32,3464,0,0,329,13179,0,0,329,13179,California
San Francisco,2021-01-03,289,13468,99,9814,190,3654,0,0,288,13466,1,1,288,13467,California
San Francisco,2021-01-04,1830,15298,1353,11167,477,4131,0,0,1827,15290,3,4,1827,15294,California
San Francisco,2021-01-05,2227,17525,1413,12580,814,4945,0,0,2193,17450,34,38,2194,17488,California
San Francisco,2021-01-06,1869,19394,1163,13743,706,5651,0,0,1605,18794,262,300,1606,19094,California
San Francisco,2021-01-07,2043,21437,1184,14927,859,6510,0,0,1596,19947,444,744,1597,20691,California
San Francisco,2021-01-08,2313,23750,1624,16551,689,7199,0,0,1481,20601,827,1571,1481,22172,California
San Francisco,2021-01-09,1393,25143,897,17448,496,7695,0,0,884,20978,509,2080,886,23058,California
San Francisco,2021-01-10,916,26059,537,17985,379,8074,0,0,463,20989,452,2532,463,23521,California
San Francisco,2021-01-11,2462,28521,1832,19817,630,8704,0,0,1398,21322,1065,3597,1398,24919,California
San Francisco,2021-01-12,3080,31601,2055,21872,1025,9729,0,0,1887,22017,1193,4790,1888,26807,California
San Francisco,2021-01-13,2805,34406,1601,23473,1204,10933,0,0,1989,23190,816,5606,1989,28796,California
San Francisco,2021-01-14,2384,36790,1066,24539,1318,12251,0,0,1847,24500,537,6143,1847,30643,California
San Francisco,2021-01-15,2740,39530,1168,25707,1572,13823,0,0,2327,26418,411,6554,2329,32972,California
San Francisco,2021-01-16,2261,41791,981,26688,1280,15103,0,0,2081,28319,180,6734,2081,35053,California
San Francisco,2021-01-17,1914,43705,526,27214,1388,16491,0,0,1703,29812,211,6945,1704,36757,California
San Francisco,2021-01-18,1382,45087,600,27814,782,17273,0,0,1109,30653,272,7217,1113,37870,California
San Francisco,2021-01-19,2551,47638,1459,29273,1092,18365,0,0,1818,31739,733,7950,1819,39689,California
San Francisco,2021-01-20,2658,50296,1063,30336,1595,19960,0,0,1926,32936,729,8679,1926,41615,California
San Francisco,2021-01-21,3260,53556,921,31257,2339,22299,0,0,2438,34554,820,9499,2438,44053,California
San Francisco,2021-01-22,3161,56717,627,31884,2534,24833,0,0,2714,36823,445,9944,2714,46767,California
San Francisco,2021-01-23,3090,59807,605,32489,2485,27318,0,0,2725,39186,363,10307,2726,49493,California
San Francisco,2021-01-24,2424,62231,361,32850,2063,29381,0,0,2195,41157,224,10531,2195,51688,California
San Francisco,2021-01-25,4539,66770,1766,34616,2773,32154,0,0,3000,42627,1537,12068,3007,54695,California
San Francisco,2021-01-26,4608,71378,2102,36718,2506,34660,0,0,3039,44100,1567,13635,3040,57735,California
San Francisco,2021-01-27,4390,75768,2060,38778,2330,36990,0,0,3052,45818,1335,14970,3053,60788,California
San Francisco,2021-01-28,3715,79483,1531,40309,2184,39174,0,0,2550,47209,1159,16129,2550,63338,California
San Francisco,2021-01-29,4669,84152,1648,41957,3021,42195,0,0,3419,49384,1244,17373,3419,66757,California
San Francisco,2021-01-30,3710,87862,1786,43743,1924,44119,0,0,3315,52305,395,17768,3316,70073,California
San Francisco,2021-01-31,2381,90243,863,44606,1518,45637,0,0,2178,54284,201,17969,2180,72253,California
San Francisco,2021-02-01,3729,93972,1493,46099,2236,47873,0,0,2841,56238,888,18857,2842,75095,California
San Francisco,2021-02-02,4617,98589,1949,48048,2668,50541,0,0,2859,57345,1752,20609,2859,77954,California
San Francisco,2021-02-03,5040,103629,2358,50406,2682,53223,0,0,3745,59797,1293,21902,3745,81699,California
San Francisco,2021-02-04,5006,108635,2425,52831,2581,55804,0,0,3854,62501,1150,23052,3854,85553,California
San Francisco,2021-02-05,5899,114534,3176,56007,2723,58527,0,0,4584,65775,1312,24364,4586,90139,California
San Francisco,2021-02-06,5424,119958,3631,59638,1793,60320,0,0,4526,69407,894,25258,4526,94665,California
San Francisco,2021-02-07,4291,124249,3162,62800,1129,61449,0,0,3724,72567,566,25824,3726,98391,California
San Francisco,2021-02-08,6580,130829,4536,67336,2044,63493,0,0,5396,76797,1166,26990,5396,103787,California
San Francisco,2021-02-09,5871,136700,3961,71297,1910,65403,0,0,4335,79599,1533,28523,4335,108122,California
San Francisco,2021-02-10,6778,143478,4143,75440,2635,68038,0,0,5047,82924,1723,30246,5048,113170,California
San Francisco,2021-02-11,6520,149998,3852,79292,2668,70706,0,0,4771,85949,1747,31993,4772,117942,California
San Francisco,2021-02-12,5174,155172,2615,81907,2559,73265,0,0,3409,87594,1764,33757,3409,121351,California
San Francisco,2021-02-13,4138,159310,2384,84291,1754,75019,0,0,2837,89133,1299,35056,2838,124189,California
San Francisco,2021-02-14,3406,162716,2236,86527,1170,76189,0,0,2293,90316,1112,36168,2295,126484,California
San Francisco,2021-02-15,2723,165439,1471,87998,1252,77441,0,0,1655,90906,1067,37235,1657,128141,California
San Francisco,2021-02-16,4860,170299,2656,90654,2204,79645,0,0,2909,91874,1943,39178,2911,131052,California
San Francisco,2021-02-17,5191,175490,2632,93286,2559,82204,0,0,2854,92398,2330,41508,2854,133906,California
San Francisco,2021-02-18,4897,180387,2494,95780,2403,84607,0,0,2563,92628,2333,43841,2563,136469,California
San Francisco,2021-02-19,4949,185336,2545,98325,2404,87011,0,0,2689,93064,2255,46096,2691,139160,California
San Francisco,2021-02-20,4227,189563,2024,100349,2203,89214,0,0,1663,92169,2558,48654,1663,140823,California
San Francisco,2021-02-21,2178,191741,1118,101467,1060,90274,0,0,905,91804,1270,49924,905,141728,California
San Francisco,2021-02-22,4900,196641,3054,104521,1846,92120,0,0,2487,91887,2407,52331,2490,144218,California
San Francisco,2021-02-23,5293,201934,2994,107515,2299,94419,0,0,2691,91985,2596,54927,2694,146912,California
San Francisco,2021-02-24,8695,210629,4908,112423,3787,98206,0,0,4615,92530,4072,58999,4617,151529,California
San Francisco,2021-02-25,9457,220086,6697,119120,2760,100966,0,0,6118,95310,3341,62340,6121,157650,California
San Francisco,2021-02-26,11184,231270,7388,126508,3796,104762,0,0,6657,97446,4523,66863,6659,164309,California
San Francisco,2021-02-27,8669,239939,5544,132052,3124,107886,1,1,4384,97557,4275,71138,4386,168695,California
San Francisco,2021-02-28,7504,247443,5401,137453,2103,109989,0,1,3707,97475,3790,74928,3708,172403,California
San Francisco,2021-03-01,9614,257057,6770,144223,2844,112833,0,1,4784,97445,4815,79743,4785,177188,California
San Francisco,2021-03-02,8291,265348,5329,149552,2962,115795,0,1,4824,98811,3459,83202,4825,182013,California
San Francisco,2021-03-03,9985,275333,5864,155416,4121,119916,0,1,5294,99425,4680,87882,5294,187307,California
San Francisco,2021-03-04,7548,282881,5079,160495,2469,122385,0,1,4239,100369,3296,91178,4240,191547,California
San Francisco,2021-03-05,7614,290495,4790,165285,2821,125206,3,4,4768,102309,2835,94013,4775,196322,California
San Francisco,2021-03-06,6624,297119,4361,169646,2054,127260,209,213,4156,104216,2457,96470,4364,200686,California
San Francisco,2021-03-07,5029,302148,3928,173574,1042,128302,59,272,2806,104862,2219,98689,2865,203551,California
San Francisco,2021-03-08,6657,308805,4920,178494,1613,129915,124,396,5205,108744,1449,100138,5331,208882,California
San Francisco,2021-03-09,6496,315301,3760,182254,2359,132274,377,773,4448,111528,2041,102179,4825,213707,California
San Francisco,2021-03-10,9892,325193,5681,187935,3738,136012,473,1246,6074,114274,3804,105983,6550,220257,California
San Francisco,2021-03-11,9236,334429,5752,193687,2667,138679,817,2063,6174,118216,3051,109034,6993,227250,California
San Francisco,2021-03-12,9252,343681,5410,199097,2837,141516,1005,3068,5327,120649,3902,112936,6335,233585,California
San Francisco,2021-03-13,5718,349399,3539,202636,1401,142917,778,3846,3709,123132,2005,114941,4488,238073,California
San Francisco,2021-03-14,7229,356628,4708,207344,2289,145206,232,4078,4097,124335,3126,118067,4329,242402,California
San Francisco,2021-03-15,11788,368416,8984,216328,1925,147131,879,4957,8233,129901,3546,121613,9112,251514,California
San Francisco,2021-03-16,11851,380267,8126,224454,3271,150402,454,5411,8714,135942,3124,124737,9165,260679,California
San Francisco,2021-03-17,12065,392332,7648,232102,3894,154296,523,5934,8746,141912,3302,128039,9272,269951,California
San Francisco,2021-03-18,6722,399054,4987,237089,1466,155762,269,6203,3959,143389,2751,130790,4228,274179,California
San Francisco,2021-03-19,6099,405153,4666,241755,1197,156959,236,6439,3144,143820,2949,133739,3380,277559,California
Tuolumne,2020-12-16,46,46,46,46,0,0,0,0,46,46,0,0,46,46,California
Tuolumne,2020-12-17,23,69,23,69,0,0,0,0,23,69,0,0,23,69,California
Tuolumne,2020-12-18,173,242,172,241,1,1,0,0,173,242,0,0,173,242,California
Tuolumne,2020-12-19,7,249,7,248,0,1,0,0,7,249,0,0,7,249,California
Tuolumne,2020-12-20,1,250,1,249,0,1,0,0,1,250,0,0,1,250,California
Tuolumne,2020-12-21,115,365,100,349,15,16,0,0,115,365,0,0,115,365,California
Tuolumne,2020-12-22,165,530,165,514,0,16,0,0,165,530,0,0,165,530,California
Tuolumne,2020-12-23,190,720,188,702,2,18,0,0,190,720,0,0,190,720,California
Tuolumne,2020-12-26,3,723,3,705,0,18,0,0,3,723,0,0,3,723,California
Tuolumne,2020-12-28,78,801,77,782,1,19,0,0,78,801,0,0,78,801,California
Tuolumne,2020-12-29,111,912,39,821,72,91,0,0,111,912,0,0,111,912,California
Tuolumne,2020-12-30,79,991,21,842,58,149,0,0,79,991,0,0,79,991,California
Tuolumne,2020-12-31,27,1018,20,862,7,156,0,0,27,1018,0,0,27,1018,California
Tuolumne,2021-01-01,6,1024,5,867,1,157,0,0,6,1024,0,0,6,1024,California
Tuolumne,2021-01-02,118,1142,115,982,3,160,0,0,118,1142,0,0,118,1142,California
Tuolumne,2021-01-03,3,1145,2,984,1,161,0,0,3,1145,0,0,3,1145,California
Tuolumne,2021-01-04,69,1214,27,1011,42,203,0,0,69,1214,0,0,69,1214,California
Tuolumne,2021-01-05,95,1309,26,1037,69,272,0,0,94,1307,1,1,94,1308,California
Tuolumne,2021-01-06,111,1420,52,1089,59,331,0,0,67,1330,44,45,67,1375,California
Tuolumne,2021-01-07,119,1539,61,1150,58,389,0,0,65,1341,54,99,65,1440,California
Tuolumne,2021-01-08,175,1714,150,1300,25,414,0,0,27,1223,147,246,29,1469,California
Tuolumne,2021-01-09,1,1715,0,1300,1,415,0,0,1,1224,0,246,1,1470,California
Tuolumne,2021-01-10,3,1718,1,1301,2,417,0,0,3,1227,0,246,3,1473,California
Tuolumne,2021-01-11,115,1833,87,1388,28,445,0,0,34,1180,81,327,34,1507,California
Tuolumne,2021-01-12,99,1932,85,1473,14,459,0,0,15,1112,84,411,16,1523,California
Tuolumne,2021-01-13,237,2169,128,1601,109,568,0,0,182,1240,55,466,183,1706,California
Tuolumne,2021-01-14,128,2297,92,1693,36,604,0,0,41,1195,86,552,41,1747,California
Tuolumne,2021-01-15,474,2771,71,1764,403,1007,0,0,412,1546,61,613,412,2159,California
Tuolumne,2021-01-16,6,2777,2,1766,4,1011,0,0,5,1550,1,614,5,2164,California
Tuolumne,2021-01-17,4,2781,1,1767,3,1014,0,0,4,1554,0,614,4,2168,California
Tuolumne,2021-01-18,47,2828,38,1805,9,1023,0,0,9,1527,37,651,10,2178,California
Tuolumne,2021-01-19,469,3297,69,1874,400,1423,0,0,427,1912,42,693,427,2605,California
Tuolumne,2021-01-20,75,3372,59,1933,16,1439,0,0,22,1881,53,746,22,2627,California
Tuolumne,2021-01-21,58,3430,22,1955,36,1475,0,0,42,1908,16,762,43,2670,California
Tuolumne,2021-01-22,181,3611,13,1968,168,1643,0,0,175,2077,6,768,175,2845,California
Tuolumne,2021-01-23,666,4277,146,2114,520,2163,0,0,553,2526,113,881,562,3407,California
Tuolumne,2021-01-24,523,4800,1,2115,522,2685,0,0,520,3044,3,884,521,3928,California
Tuolumne,2021-01-25,48,4848,27,2142,21,2706,0,0,22,3041,26,910,23,3951,California
Tuolumne,2021-01-26,81,4929,69,2211,12,2718,0,0,41,3042,40,950,41,3992,California
Tuolumne,2021-01-27,60,4989,5,2216,55,2773,0,0,8,2998,52,1002,8,4000,California
Tuolumne,2021-01-28,27,5016,7,2223,20,2793,0,0,18,3007,9,1011,18,4018,California
Tuolumne,2021-01-29,71,5087,7,2230,64,2857,0,0,33,3002,38,1049,33,4051,California
Tuolumne,2021-01-30,708,5795,551,2781,157,3014,0,0,690,3685,18,1067,701,4752,California
Tuolumne,2021-01-31,8,5803,2,2783,6,3020,0,0,6,3689,2,1069,6,4758,California
Tuolumne,2021-02-01,25,5828,6,2789,19,3039,0,0,22,3708,3,1072,22,4780,California
Tuolumne,2021-02-02,649,6477,35,2824,614,3653,0,0,639,4338,10,1082,640,5420,California
Tuolumne,2021-02-03,237,6714,108,2932,129,3782,0,0,85,4271,152,1234,85,5505,California
Tuolumne,2021-02-04,128,6842,14,2946,114,3896,0,0,67,4275,63,1297,67,5572,California
Tuolumne,2021-02-05,98,6940,12,2958,86,3982,0,0,35,4248,62,1359,35,5607,California
Tuolumne,2021-02-06,848,7788,577,3535,271,4253,0,0,847,5094,1,1360,847,6454,California
Tuolumne,2021-02-07,7,7795,4,3539,3,4256,0,0,3,5093,4,1364,3,6457,California
Tuolumne,2021-02-08,90,7885,38,3577,52,4308,0,0,67,5137,23,1387,67,6524,California
Tuolumne,2021-02-09,864,8749,45,3622,819,5127,0,0,828,5929,36,1423,828,7352,California
Tuolumne,2021-02-10,89,8838,13,3635,76,5203,0,0,28,5899,59,1482,29,7381,California
Tuolumne,2021-02-11,138,8976,66,3701,72,5275,0,0,76,5913,62,1544,76,7457,California
Tuolumne,2021-02-12,641,9617,12,3713,629,5904,0,0,204,5682,437,1981,206,7663,California
Tuolumne,2021-02-13,145,9762,40,3753,105,6009,0,0,114,5772,25,2006,115,7778,California
Tuolumne,2021-02-14,141,9903,10,3763,131,6140,0,0,140,5911,1,2007,140,7918,California
Tuolumne,2021-02-15,182,10085,8,3771,174,6314,0,0,171,6072,11,2018,172,8090,California
Tuolumne,2021-02-16,519,10604,19,3790,500,6814,0,0,116,5791,401,2419,120,8210,California
Tuolumne,2021-02-17,103,10707,62,3852,41,6855,0,0,60,5809,42,2461,60,8270,California
Tuolumne,2021-02-18,676,11383,20,3872,656,7511,0,0,627,6387,49,2510,627,8897,California
Tuolumne,2021-02-19,133,11516,20,3892,113,7624,0,0,42,6339,91,2601,43,8940,California
Tuolumne,2021-02-20,902,12418,343,4235,559,8183,0,0,383,6216,508,3109,385,9325,California
Tuolumne,2021-02-21,976,13394,32,4267,944,9127,0,0,471,6187,502,3611,473,9798,California
Tuolumne,2021-02-22,73,13467,50,4317,23,9150,0,0,42,6199,31,3642,43,9841,California
Tuolumne,2021-02-23,40,13507,21,4338,19,9169,0,0,21,6202,18,3660,21,9862,California
Tuolumne,2021-02-24,81,13588,50,4388,31,9200,0,0,29,6186,52,3712,36,9898,California
Tuolumne,2021-02-25,1036,14624,30,4418,1006,10206,0,0,1006,7162,30,3742,1006,10904,California
Tuolumne,2021-02-26,135,14759,7,4425,128,10334,0,0,112,7253,23,3765,114,11018,California
Tuolumne,2021-02-27,944,15703,573,4998,371,10705,0,0,243,6808,689,4454,244,11262,California
Tuolumne,2021-02-28,45,15748,4,5002,41,10746,0,0,43,6850,1,4455,43,11305,California
Tuolumne,2021-03-01,100,15848,20,5022,80,10826,0,0,67,6887,32,4487,69,11374,California
Tuolumne,2021-03-02,701,16549,67,5089,634,11460,0,0,102,6393,599,5086,105,11479,California
Tuolumne,2021-03-03,78,16627,18,5107,60,11520,0,0,54,6426,23,5109,56,11535,California
Tuolumne,2021-03-04,1135,17762,64,5171,1071,12591,0,0,1083,7457,52,5161,1083,12618,California
Tuolumne,2021-03-05,74,17836,8,5179,66,12657,0,0,42,7469,30,5191,42,12660,California
Tuolumne,2021-03-06,1040,18876,601,5780,437,13094,2,2,192,6821,847,6038,199,12859,California
Tuolumne,2021-03-07,30,18906,9,5789,8,13102,13,15,10,6825,20,6058,24,12883,California
Tuolumne,2021-03-08,185,19091,87,5876,91,13193,7,22,127,6904,57,6115,136,13019,California
Tuolumne,2021-03-09,873,19964,14,5890,849,14042,10,32,80,6206,792,6907,94,13113,California
Tuolumne,2021-03-10,87,20051,14,5904,63,14105,10,42,47,6224,39,6946,57,13170,California
Tuolumne,2021-03-11,1245,21296,26,5930,1215,15320,4,46,1207,7398,38,6984,1212,14382,California
Tuolumne,2021-03-12,251,21547,32,5962,206,15526,13,59,110,7420,140,7124,162,14544,California
Tuolumne,2021-03-13,59,21606,11,5973,48,15574,0,59,18,7421,41,7165,42,14586,California
Tuolumne,2021-03-14,82,21688,8,5981,65,15639,9,68,3,7357,79,7244,15,14601,California
Tuolumne,2021-03-15,288,21976,70,6051,217,15856,1,69,101,7277,186,7430,106,14707,California
Tuolumne,2021-03-16,790,22766,40,6091,740,16596,10,79,657,7813,132,7562,668,15375,California
Tuolumne,2021-03-17,130,22896,23,6114,95,16691,12,91,60,7816,70,7632,73,15448,California
Tuolumne,2021-03-18,734,23630,14,6128,703,17394,17,108,233,7567,501,8133,252,15700,California
Tuolumne,2021-03-19,67,23697,9,6137,46,17440,12,120,31,7577,36,8169,46,15746,California
Tehama,2020-12-15,1,1,1,1,0,0,0,0,1,1,0,0,1,1,California
Tehama,2020-12-16,2,3,2,3,0,0,0,0,2,3,0,0,2,3,California
Tehama,2020-12-17,12,15,12,15,0,0,0,0,12,15,0,0,12,15,California
Tehama,2020-12-18,2,17,2,17,0,0,0,0,3,18,0,0,3,18,California
Tehama,2020-12-21,33,50,33,50,0,0,0,0,33,51,0,0,33,51,California
Tehama,2020-12-22,68,118,62,112,6,6,0,0,68,119,0,0,68,119,California
Tehama,2020-12-23,48,166,40,152,8,14,0,0,48,167,0,0,48,167,California
Tehama,2020-12-24,5,171,3,155,2,16,0,0,5,172,0,0,5,172,California
Tehama,2020-12-26,3,174,2,157,1,17,0,0,3,175,0,0,3,175,California
Tehama,2020-12-27,2,176,2,159,0,17,0,0,2,177,0,0,2,177,California
Tehama,2020-12-28,56,232,43,202,13,30,0,0,56,233,0,0,56,233,California
Tehama,2020-12-29,31,263,31,233,0,30,0,0,31,264,0,0,31,264,California
Tehama,2020-12-30,54,317,38,271,16,46,0,0,53,317,0,0,53,317,California
Tehama,2020-12-31,14,331,4,275,10,56,0,0,14,331,0,0,14,331,California
Tehama,2021-01-01,2,333,0,275,2,58,0,0,2,333,0,0,2,333,California
Tehama,2021-01-04,31,364,8,283,23,81,0,0,31,364,0,0,31,364,California
Tehama,2021-01-05,71,435,44,327,27,108,0,0,68,429,3,3,68,432,California
Tehama,2021-01-06,70,505,21,348,49,157,0,0,61,482,8,11,61,493,California
Tehama,2021-01-07,57,562,7,355,50,207,0,0,56,537,1,12,56,549,California
Tehama,2021-01-08,30,592,24,379,6,213,0,0,25,557,5,17,25,574,California
Tehama,2021-01-09,7,599,5,384,2,215,0,0,5,560,2,19,5,579,California
Tehama,2021-01-10,1,600,0,384,1,216,0,0,1,561,0,19,1,580,California
Tehama,2021-01-11,47,647,46,430,1,217,0,0,14,542,33,52,14,594,California
Tehama,2021-01-12,115,762,95,525,20,237,0,0,70,567,45,97,70,664,California
Tehama,2021-01-13,72,834,55,580,17,254,0,0,26,547,46,143,26,690,California
Tehama,2021-01-14,226,1060,51,631,175,429,0,0,224,769,2,145,224,914,California
Tehama,2021-01-15,246,1306,74,705,172,601,0,0,242,1007,4,149,242,1156,California
Tehama,2021-01-16,274,1580,27,732,247,848,0,0,271,1275,3,152,271,1427,California
Tehama,2021-01-17,13,1593,9,741,4,852,0,0,11,1284,2,154,11,1438,California
Tehama,2021-01-18,10,1603,6,747,4,856,0,0,5,1284,5,159,5,1443,California
Tehama,2021-01-19,289,1892,61,808,228,1084,0,0,234,1463,55,214,234,1677,California
Tehama,2021-01-20,303,2195,88,896,215,1299,0,0,252,1665,50,264,252,1929,California
Tehama,2021-01-21,214,2409,11,907,203,1502,0,0,204,1859,10,274,204,2133,California
Tehama,2021-01-22,214,2623,12,919,202,1704,0,0,211,2067,3,277,211,2344,California
Tehama,2021-01-23,263,2886,10,929,253,1957,0,0,261,2327,2,279,262,2606,California
Tehama,2021-01-25,30,2916,13,942,17,1974,0,0,13,2323,17,296,13,2619,California
Tehama,2021-01-26,325,3241,41,983,284,2258,0,0,287,2573,38,334,288,2907,California
Tehama,2021-01-27,299,3540,21,1004,278,2536,0,0,279,2832,20,354,279,3186,California
Tehama,2021-01-28,334,3874,25,1029,309,2845,0,0,319,3136,15,369,319,3505,California
Tehama,2021-01-29,320,4194,18,1047,302,3147,0,0,303,3422,17,386,303,3808,California
Tehama,2021-01-30,102,4296,2,1049,100,3247,0,0,101,3522,1,387,101,3909,California
Tehama,2021-01-31,1,4297,0,1049,1,3248,0,0,1,3523,0,387,1,3910,California
Tehama,2021-02-01,78,4375,23,1072,55,3303,0,0,37,3519,41,428,37,3947,California
Tehama,2021-02-02,311,4686,62,1134,249,3552,0,0,215,3641,93,521,215,4162,California
Tehama,2021-02-03,356,5042,12,1146,344,3896,0,0,312,3909,44,565,312,4474,California
Tehama,2021-02-04,440,5482,96,1242,344,4240,0,0,362,4193,78,643,362,4836,California
Tehama,2021-02-05,158,5640,73,1315,85,4325,0,0,99,4233,59,702,99,4935,California
Tehama,2021-02-06,29,5669,13,1328,16,4341,0,0,17,4238,12,714,17,4952,California
Tehama,2021-02-07,5,5674,4,1332,1,4342,0,0,2,4237,3,717,2,4954,California
Tehama,2021-02-08,35,5709,14,1346,21,4363,0,0,27,4256,8,725,27,4981,California
Tehama,2021-02-09,74,5783,31,1377,43,4406,0,0,40,4262,34,759,40,5021,California
Tehama,2021-02-10,229,6012,58,1435,171,4577,0,0,157,4347,72,831,157,5178,California
Tehama,2021-02-11,218,6230,14,1449,204,4781,0,0,79,4289,137,968,79,5257,California
Tehama,2021-02-12,346,6576,49,1498,297,5078,0,0,165,4273,181,1149,165,5422,California
Tehama,2021-02-13,389,6965,12,1510,377,5455,0,0,148,4180,241,1390,148,5570,California
Tehama,2021-02-14,33,6998,0,1510,33,5488,0,0,32,4211,1,1391,32,5602,California
Tehama,2021-02-15,51,7049,9,1519,42,5530,0,0,45,4250,6,1397,45,5647,California
Tehama,2021-02-16,237,7286,13,1532,224,5754,0,0,56,4125,181,1578,56,5703,California
Tehama,2021-02-17,291,7577,21,1553,270,6024,0,0,65,3964,226,1804,65,5768,California
Tehama,2021-02-18,344,7921,36,1589,308,6332,0,0,124,3868,220,2024,124,5892,California
Tehama,2021-02-19,214,8135,17,1606,197,6529,0,0,44,3742,170,2194,44,5936,California
Tehama,2021-02-20,273,8408,6,1612,267,6796,0,0,26,3522,246,2440,26,5962,California
Tehama,2021-02-22,39,8447,15,1627,24,6820,0,0,26,3535,13,2453,26,5988,California
Tehama,2021-02-23,43,8490,18,1645,25,6845,0,0,23,3538,20,2473,23,6011,California
Tehama,2021-02-24,294,8784,9,1654,285,7130,0,0,23,3290,271,2744,23,6034,California
Tehama,2021-02-25,375,9159,61,1715,314,7444,0,0,38,2991,337,3081,38,6072,California
Tehama,2021-02-26,449,9608,17,1732,432,7876,0,0,65,2672,384,3465,65,6137,California
Tehama,2021-02-27,296,9904,6,1738,290,8166,0,0,35,2446,261,3726,35,6172,California
Tehama,2021-02-28,22,9926,2,1740,20,8186,0,0,19,2462,3,3729,19,6191,California
Tehama,2021-03-01,61,9987,8,1748,53,8239,0,0,28,2457,33,3762,28,6219,California
Tehama,2021-03-02,74,10061,14,1762,60,8299,0,0,27,2437,47,3809,27,6246,California
Tehama,2021-03-03,85,10146,28,1790,57,8356,0,0,37,2426,48,3857,37,6283,California
Tehama,2021-03-04,513,10659,18,1808,495,8851,0,0,193,2304,315,4172,193,6476,California
Tehama,2021-03-05,340,10999,21,1829,319,9170,0,0,189,2343,150,4322,189,6665,California
Tehama,2021-03-06,277,11276,10,1839,267,9437,0,0,71,2210,205,4527,72,6737,California
Tehama,2021-03-07,8,11284,2,1841,6,9443,0,0,6,2214,2,4529,6,6743,California
Tehama,2021-03-08,47,11331,10,1851,24,9467,13,13,21,2223,25,4554,34,6777,California
Tehama,2021-03-09,269,11600,5,1856,255,9722,9,22,230,2423,39,4593,239,7016,California
Tehama,2021-03-10,307,11907,12,1868,291,10013,4,26,62,2245,244,4837,66,7082,California
Tehama,2021-03-11,438,12345,22,1890,381,10394,35,61,312,2466,126,4963,347,7429,California
Tehama,2021-03-12,230,12575,13,1903,171,10565,46,107,151,2584,79,5042,197,7626,California
Tehama,2021-03-13,28,12603,9,1912,13,10578,6,113,6,2574,22,5064,12,7638,California
Tehama,2021-03-14,29,12632,2,1914,16,10594,11,124,4,2564,25,5089,15,7653,California
Tehama,2021-03-15,154,12786,23,1937,106,10700,25,149,80,2595,74,5163,105,7758,California
Tehama,2021-03-16,358,13144,15,1952,309,11009,34,183,267,2806,90,5253,301,8059,California
Tehama,2021-03-17,377,13521,29,1981,329,11338,19,202,308,3066,67,5320,327,8386,California
Tehama,2021-03-18,370,13891,13,1994,353,11691,4,206,259,3219,110,5430,263,8649,California
Tehama,2021-03-19,139,14030,7,2001,132,11823,0,206,124,3328,15,5445,124,8773,California
Lassen,2020-12-16,8,8,8,8,0,0,0,0,8,8,0,0,8,8,California
Lassen,2020-12-17,6,14,6,14,0,0,0,0,6,14,0,0,6,14,California
Lassen,2020-12-18,1,15,1,15,0,0,0,0,1,15,0,0,1,15,California
Lassen,2020-12-19,5,20,5,20,0,0,0,0,5,20,0,0,5,20,California
Lassen,2020-12-20,2,22,2,22,0,0,0,0,2,22,0,0,2,22,California
Lassen,2020-12-21,11,33,11,33,0,0,0,0,11,33,0,0,11,33,California
Lassen,2020-12-22,23,56,23,56,0,0,0,0,23,56,0,0,23,56,California
Lassen,2020-12-23,6,62,6,62,0,0,0,0,6,62,0,0,6,62,California
Lassen,2020-12-24,11,73,11,73,0,0,0,0,11,73,0,0,11,73,California
Lassen,2020-12-28,3,76,2,75,1,1,0,0,3,76,0,0,3,76,California
Lassen,2020-12-29,35,111,35,110,0,1,0,0,35,111,0,0,35,111,California
Lassen,2020-12-30,37,148,36,146,1,2,0,0,37,148,0,0,37,148,California
Lassen,2020-12-31,51,199,42,188,9,11,0,0,51,199,0,0,51,199,California
Lassen,2021-01-02,1,200,0,188,1,12,0,0,1,200,0,0,1,200,California
Lassen,2021-01-04,15,215,1,189,14,26,0,0,15,215,0,0,15,215,California
Lassen,2021-01-05,194,409,53,242,141,167,0,0,194,409,0,0,194,409,California
Lassen,2021-01-06,94,503,42,284,52,219,0,0,86,488,8,8,87,496,California
Lassen,2021-01-07,43,546,7,291,36,255,0,0,37,519,6,14,37,533,California
Lassen,2021-01-08,50,596,2,293,48,303,0,0,50,569,0,14,50,583,California
Lassen,2021-01-09,12,608,6,299,6,309,0,0,12,581,0,14,12,595,California
Lassen,2021-01-11,27,635,5,304,22,331,0,0,27,608,0,14,27,622,California
Lassen,2021-01-12,50,685,30,334,20,351,0,0,31,620,19,33,31,653,California
Lassen,2021-01-13,161,846,18,352,143,494,0,0,146,751,15,48,146,799,California
Lassen,2021-01-14,161,1007,18,370,143,637,0,0,149,888,12,60,149,948,California
Lassen,2021-01-15,33,1040,6,376,27,664,0,0,33,921,0,60,33,981,California
Lassen,2021-01-16,34,1074,33,409,1,665,0,0,34,955,0,60,34,1015,California
Lassen,2021-01-17,1,1075,0,409,1,666,0,0,1,956,0,60,1,1016,California
Lassen,2021-01-18,5,1080,2,411,3,669,0,0,4,959,1,61,4,1020,California
Lassen,2021-01-19,186,1266,36,447,150,819,0,0,158,1089,28,89,158,1178,California
Lassen,2021-01-20,185,1451,99,546,86,905,0,0,101,1121,69,158,101,1279,California
Lassen,2021-01-21,145,1596,94,640,51,956,0,0,120,1223,18,176,120,1399,California
Lassen,2021-01-22,32,1628,19,659,13,969,0,0,22,1235,10,186,22,1421,California
Lassen,2021-01-23,1,1629,0,659,1,970,0,0,1,1236,0,186,1,1422,California
Lassen,2021-01-24,1,1630,0,659,1,971,0,0,1,1237,0,186,1,1423,California
Lassen,2021-01-25,12,1642,1,660,11,982,0,0,12,1249,0,186,12,1435,California
Lassen,2021-01-26,126,1768,12,672,114,1096,0,0,122,1367,4,190,122,1557,California
Lassen,2021-01-27,79,1847,28,700,51,1147,0,0,63,1414,16,206,63,1620,California
Lassen,2021-01-28,85,1932,14,714,71,1218,0,0,84,1497,1,207,84,1704,California
Lassen,2021-01-29,23,1955,7,721,16,1234,0,0,22,1518,1,208,22,1726,California
Lassen,2021-02-01,61,2016,4,725,57,1291,0,0,35,1527,26,234,35,1761,California
Lassen,2021-02-02,175,2191,11,736,164,1455,0,0,43,1438,132,366,43,1804,California
Lassen,2021-02-03,99,2290,22,758,77,1532,0,0,54,1447,45,411,54,1858,California
Lassen,2021-02-04,111,2401,14,772,97,1629,0,0,62,1460,49,460,62,1920,California
Lassen,2021-02-05,65,2466,12,784,53,1682,0,0,23,1441,42,502,23,1943,California
Lassen,2021-02-06,70,2536,35,819,35,1717,0,0,37,1446,32,534,37,1980,California
Lassen,2021-02-07,1,2537,1,820,0,1717,0,0,1,1447,0,534,1,1981,California
Lassen,2021-02-08,45,2582,6,826,39,1756,0,0,20,1442,25,559,20,2001,California
Lassen,2021-02-09,127,2709,8,834,119,1875,0,0,48,1411,79,638,48,2049,California
Lassen,2021-02-10,180,2889,19,853,161,2036,0,0,74,1380,105,743,74,2123,California
Lassen,2021-02-11,174,3063,15,868,159,2195,0,0,76,1359,97,840,76,2199,California
Lassen,2021-02-12,45,3108,12,880,33,2228,0,0,17,1348,28,868,17,2216,California
Lassen,2021-02-13,13,3121,5,885,8,2236,0,0,11,1357,2,870,11,2227,California
Lassen,2021-02-14,13,3134,0,885,13,2249,0,0,12,1368,1,871,12,2239,California
Lassen,2021-02-15,22,3156,4,889,18,2267,0,0,17,1380,5,876,17,2256,California
Lassen,2021-02-16,192,3348,3,892,189,2456,0,0,30,1250,160,1036,30,2286,California
Lassen,2021-02-17,184,3532,95,987,89,2545,0,0,11,1088,173,1209,11,2297,California
Lassen,2021-02-18,74,3606,22,1009,52,2597,0,0,20,1054,54,1263,20,2317,California
Lassen,2021-02-19,82,3688,61,1070,21,2618,0,0,18,1008,64,1327,18,2335,California
Lassen,2021-02-20,7,3695,0,1070,7,2625,0,0,5,1011,2,1329,5,2340,California
Lassen,2021-02-21,18,3713,1,1071,17,2642,0,0,15,1023,3,1332,15,2355,California
Lassen,2021-02-22,23,3736,8,1079,15,2657,0,0,5,1010,18,1350,5,2360,California
Lassen,2021-02-23,151,3887,8,1087,143,2800,0,0,40,939,111,1461,40,2400,California
Lassen,2021-02-24,163,4050,14,1101,149,2949,0,0,106,989,56,1517,106,2506,California
Lassen,2021-02-25,146,4196,10,1111,136,3085,0,0,90,1023,56,1573,90,2596,California
Lassen,2021-02-26,65,4261,9,1120,56,3141,0,0,31,1020,34,1607,31,2627,California
Lassen,2021-02-27,8,4269,7,1127,1,3142,0,0,4,1020,4,1611,4,2631,California
Lassen,2021-02-28,5,4274,1,1128,4,3146,0,0,2,1019,3,1614,2,2633,California
Lassen,2021-03-01,39,4313,5,1133,34,3180,0,0,6,992,33,1647,6,2639,California
Lassen,2021-03-02,101,4414,5,1138,96,3276,0,0,77,1045,24,1671,77,2716,California
Lassen,2021-03-03,156,4570,12,1150,144,3420,0,0,101,1091,55,1726,101,2817,California
Lassen,2021-03-04,139,4709,12,1162,127,3547,0,0,91,1135,47,1773,91,2908,California
Lassen,2021-03-05,45,4754,6,1168,19,3566,20,20,12,1134,33,1806,32,2940,California
Lassen,2021-03-06,49,4803,5,1173,27,3593,17,37,4,1110,45,1851,21,2961,California
Lassen,2021-03-07,55,4858,1,1174,0,3593,54,91,0,1109,55,1906,54,3015,California
Lassen,2021-03-08,87,4945,2,1176,8,3601,77,168,3,1106,83,1989,80,3095,California
Lassen,2021-03-09,113,5058,11,1187,96,3697,6,174,77,1153,36,2025,83,3178,California
Lassen,2021-03-10,149,5207,8,1195,140,3837,1,175,66,1138,83,2108,68,3246,California
Lassen,2021-03-11,167,5374,16,1211,142,3979,9,184,98,1179,66,2174,107,3353,California
Lassen,2021-03-12,33,5407,15,1226,11,3990,7,191,11,1175,22,2196,18,3371,California
Lassen,2021-03-13,45,5452,0,1226,2,3992,43,234,2,1176,43,2239,44,3415,California
Lassen,2021-03-14,7,5459,1,1227,5,3997,1,235,0,1170,7,2246,1,3416,California
Lassen,2021-03-15,29,5488,2,1229,24,4021,3,238,10,1164,18,2264,12,3428,California
Lassen,2021-03-16,85,5573,3,1232,77,4098,5,243,68,1220,17,2281,73,3501,California
Lassen,2021-03-17,560,6133,9,1241,547,4645,4,247,543,1751,16,2297,547,4048,California
Lassen,2021-03-18,75,6208,5,1246,69,4714,1,248,65,1807,10,2307,66,4114,California
Lassen,2021-03-19,4,6212,4,1250,0,4714,0,248,3,1809,1,2308,3,4117,California
Shasta,2020-12-16,131,131,131,131,0,0,0,0,131,131,0,0,131,131,California
Shasta,2020-12-17,418,549,418,549,0,0,0,0,418,549,0,0,418,549,California
Shasta,2020-12-18,168,717,168,717,0,0,0,0,168,717,0,0,168,717,California
Shasta,2020-12-19,1,718,1,718,0,0,0,0,1,718,0,0,1,718,California
Shasta,2020-12-21,78,796,78,796,0,0,0,0,78,796,0,0,78,796,California
Shasta,2020-12-22,191,987,186,982,5,5,0,0,191,987,0,0,191,987,California
Shasta,2020-12-23,174,1161,170,1152,4,9,0,0,174,1161,0,0,174,1161,California
Shasta,2020-12-24,18,1179,18,1170,0,9,0,0,18,1179,0,0,18,1179,California
Shasta,2020-12-26,4,1183,1,1171,3,12,0,0,4,1183,0,0,4,1183,California
Shasta,2020-12-27,1,1184,0,1171,1,13,0,0,1,1184,0,0,1,1184,California
Shasta,2020-12-28,40,1224,31,1202,9,22,0,0,40,1224,0,0,40,1224,California
Shasta,2020-12-29,186,1410,185,1387,1,23,0,0,186,1410,0,0,186,1410,California
Shasta,2020-12-30,177,1587,167,1554,10,33,0,0,177,1587,0,0,177,1587,California
Shasta,2020-12-31,81,1668,2,1556,79,112,0,0,81,1668,0,0,81,1668,California
Shasta,2021-01-02,2,1670,0,1556,2,114,0,0,2,1670,0,0,2,1670,California
Shasta,2021-01-03,1,1671,1,1557,0,114,0,0,1,1671,0,0,1,1671,California
Shasta,2021-01-04,346,2017,306,1863,40,154,0,0,347,2018,0,0,347,2018,California
Shasta,2021-01-05,335,2352,314,2177,21,175,0,0,254,2191,81,81,254,2272,California
Shasta,2021-01-06,438,2790,396,2573,42,217,0,0,175,2104,262,343,175,2447,California
Shasta,2021-01-07,116,2906,35,2608,81,298,0,0,95,2178,21,364,95,2542,California
Shasta,2021-01-08,506,3412,446,3054,60,358,0,0,297,2266,209,573,297,2839,California
Shasta,2021-01-09,72,3484,63,3117,9,367,0,0,70,2334,2,575,70,2909,California
Shasta,2021-01-10,5,3489,0,3117,5,372,0,0,4,2338,1,576,5,2914,California
Shasta,2021-01-11,352,3841,185,3302,167,539,0,0,317,2620,35,611,317,3231,California
Shasta,2021-01-12,451,4292,327,3629,124,663,0,0,277,2723,174,785,277,3508,California
Shasta,2021-01-13,541,4833,268,3897,273,936,0,0,371,2924,170,955,371,3879,California
Shasta,2021-01-14,443,5276,48,3945,395,1331,0,0,426,3333,17,972,426,4305,California
Shasta,2021-01-15,634,5910,135,4080,499,1830,0,0,632,3963,2,974,632,4937,California
Shasta,2021-01-16,900,6810,56,4136,844,2674,0,0,897,4857,3,977,897,5834,California
Shasta,2021-01-17,26,6836,6,4142,20,2694,0,0,22,4875,4,981,22,5856,California
Shasta,2021-01-18,598,7434,129,4271,469,3163,0,0,591,5459,7,988,591,6447,California
Shasta,2021-01-19,1014,8448,397,4668,617,3780,0,0,866,6177,148,1136,866,7313,California
Shasta,2021-01-20,665,9113,405,5073,260,4040,0,0,483,6482,178,1314,483,7796,California
Shasta,2021-01-21,629,9742,278,5351,351,4391,0,0,606,7065,23,1337,606,8402,California
Shasta,2021-01-22,445,10187,169,5520,276,4667,0,0,439,7498,6,1343,439,8841,California
Shasta,2021-01-23,69,10256,5,5525,64,4731,0,0,68,7565,1,1344,68,8909,California
Shasta,2021-01-24,25,10281,2,5527,23,4754,0,0,24,7588,1,1345,24,8933,California
Shasta,2021-01-25,752,11033,492,6019,260,5014,0,0,466,7769,285,1630,466,9399,California
Shasta,2021-01-26,709,11742,333,6352,376,5390,0,0,476,8014,231,1861,476,9875,California
Shasta,2021-01-27,458,12200,179,6531,279,5669,0,0,410,8376,48,1909,410,10285,California
Shasta,2021-01-28,842,13042,566,7097,276,5945,0,0,621,8776,221,2130,621,10906,California
Shasta,2021-01-29,828,13870,329,7426,499,6444,0,0,639,9227,189,2319,640,11546,California
Shasta,2021-01-30,614,14484,15,7441,599,7043,0,0,605,9823,9,2328,605,12151,California
Shasta,2021-01-31,29,14513,5,7446,24,7067,0,0,27,9848,2,2330,27,12178,California
Shasta,2021-02-01,501,15014,141,7587,360,7427,0,0,381,10109,120,2450,381,12559,California
Shasta,2021-02-02,601,15615,145,7732,456,7883,0,0,512,10533,88,2538,512,13071,California
Shasta,2021-02-03,649,16264,208,7940,441,8324,0,0,454,10792,195,2733,454,13525,California
Shasta,2021-02-04,604,16868,209,8149,395,8719,0,0,430,11048,174,2907,430,13955,California
Shasta,2021-02-05,1207,18075,163,8312,1044,9763,0,0,1018,11878,188,3095,1018,14973,California
Shasta,2021-02-06,1721,19796,42,8354,1679,11442,0,0,1697,13551,24,3119,1697,16670,California
Shasta,2021-02-07,26,19822,2,8356,24,11466,0,0,24,13573,2,3121,24,16694,California
Shasta,2021-02-08,526,20348,152,8508,374,11840,0,0,289,13625,237,3358,289,16983,California
Shasta,2021-02-09,730,21078,351,8859,379,12219,0,0,390,13675,340,3698,390,17373,California
Shasta,2021-02-10,631,21709,330,9189,301,12520,0,0,304,13653,327,4025,305,17678,California
Shasta,2021-02-11,780,22489,183,9372,597,13117,0,0,299,13476,476,4501,299,17977,California
Shasta,2021-02-12,1639,24128,1128,10500,511,13628,0,0,1158,14153,481,4982,1158,19135,California
Shasta,2021-02-13,1380,25508,367,10867,1013,14641,0,0,567,13908,814,5796,569,19704,California
Shasta,2021-02-14,148,25656,3,10870,145,14786,0,0,124,14008,24,5820,124,19828,California
Shasta,2021-02-15,382,26038,91,10961,291,15077,0,0,216,14058,166,5986,216,20044,California
Shasta,2021-02-16,703,26741,150,11111,553,15630,0,0,225,13806,477,6463,225,20269,California
Shasta,2021-02-17,951,27692,430,11541,521,16151,0,0,361,13577,590,7053,361,20630,California
Shasta,2021-02-18,612,28304,187,11728,425,16576,0,0,180,13325,432,7485,180,20810,California
Shasta,2021-02-19,625,28929,236,11964,389,16965,0,0,212,13124,413,7898,212,21022,California
Shasta,2021-02-20,746,29675,84,12048,662,17627,0,0,284,12946,462,8360,284,21306,California
Shasta,2021-02-21,32,29707,2,12050,30,17657,0,0,8,12931,23,8383,8,21314,California
Shasta,2021-02-22,335,30042,61,12111,274,17931,0,0,100,12796,235,8618,100,21414,California
Shasta,2021-02-23,398,30440,72,12183,326,18257,0,0,102,12602,296,8914,102,21516,California
Shasta,2021-02-24,504,30944,130,12313,374,18631,0,0,167,12434,335,9249,167,21683,California
Shasta,2021-02-25,459,31403,154,12467,305,18936,0,0,152,12280,306,9555,152,21835,California
Shasta,2021-02-26,748,32151,66,12533,682,19618,0,0,298,12130,448,10003,298,22133,California
Shasta,2021-02-27,808,32959,30,12563,778,20396,0,0,184,11693,622,10625,185,22318,California
Shasta,2021-02-28,167,33126,4,12567,163,20559,0,0,119,11764,48,10673,119,22437,California
Shasta,2021-03-01,550,33676,61,12628,489,21048,0,0,261,11739,286,10959,261,22698,California
Shasta,2021-03-02,478,34154,70,12698,408,21456,0,0,138,11537,340,11299,138,22836,California
Shasta,2021-03-03,532,34686,119,12817,413,21869,0,0,171,11347,361,11660,171,23007,California
Shasta,2021-03-04,999,35685,476,13293,523,22392,0,0,631,11611,367,12027,631,23638,California
Shasta,2021-03-05,940,36625,154,13447,759,23151,27,27,302,11304,636,12663,329,23967,California
Shasta,2021-03-06,799,37424,382,13829,373,23524,44,71,186,10922,612,13275,230,24197,California
Shasta,2021-03-07,92,37516,5,13834,57,23581,30,101,40,10940,52,13327,70,24267,California
Shasta,2021-03-08,467,37983,42,13876,303,23884,122,223,112,10822,352,13679,234,24501,California
Shasta,2021-03-09,493,38476,47,13923,337,24221,109,332,204,10846,289,13968,313,24814,California
Shasta,2021-03-10,654,39130,242,14165,329,24550,83,415,133,10541,520,14488,215,25029,California
Shasta,2021-03-11,916,40046,153,14318,565,25115,198,613,583,10989,333,14821,781,25810,California
Shasta,2021-03-12,595,40641,109,14427,313,25428,173,786,244,11055,351,15172,417,26227,California
Shasta,2021-03-13,662,41303,407,14834,165,25593,90,876,472,11427,190,15362,562,26789,California
Shasta,2021-03-14,277,41580,12,14846,242,25835,23,899,196,11565,81,15443,219,27008,California
Shasta,2021-03-15,477,42057,37,14883,340,26175,100,999,197,11583,278,15721,296,27304,California
Shasta,2021-03-16,872,42929,145,15028,665,26840,62,1061,618,12009,254,15975,680,27984,California
Shasta,2021-03-17,495,43424,141,15169,317,27157,37,1098,269,12096,219,16194,306,28290,California
Shasta,2021-03-18,299,43723,46,15215,229,27386,24,1122,182,12189,116,16310,209,28499,California
Shasta,2021-03-19,201,43924,19,15234,147,27533,35,1157,120,12265,81,16391,157,28656,California
Los Angeles,2020-12-15,391,391,391,391,0,0,0,0,391,391,0,0,391,391,California
Los Angeles,2020-12-16,3356,3747,3356,3747,0,0,0,0,3356,3747,0,0,3356,3747,California
Los Angeles,2020-12-17,10216,13963,10216,13963,0,0,0,0,10217,13964,0,0,10217,13964,California
Los Angeles,2020-12-18,14469,28432,14451,28414,18,18,0,0,14469,28433,0,0,14469,28433,California
Los Angeles,2020-12-19,7212,35644,7206,35620,6,24,0,0,7213,35646,0,0,7213,35646,California
Los Angeles,2020-12-20,4565,40209,4558,40178,7,31,0,0,4567,40213,0,0,4567,40213,California
Los Angeles,2020-12-21,13642,53851,13631,53809,11,42,0,0,13643,53855,1,1,13643,53856,California
Los Angeles,2020-12-22,11465,65316,11091,64900,374,416,0,0,11467,65322,0,1,11467,65323,California
Los Angeles,2020-12-23,11839,77155,10082,74982,1757,2173,0,0,11840,77162,0,1,11840,77163,California
Los Angeles,2020-12-24,6916,84071,4236,79218,2680,4853,0,0,6919,84081,0,1,6919,84082,California
Los Angeles,2020-12-25,521,84592,416,79634,105,4958,0,0,521,84602,0,1,521,84603,California
Los Angeles,2020-12-26,2514,87106,2173,81807,341,5299,0,0,2514,87115,1,2,2514,87117,California
Los Angeles,2020-12-27,1743,88849,1020,82827,723,6022,0,0,1743,88858,0,2,1743,88860,California
Los Angeles,2020-12-28,10215,99064,6333,89160,3882,9904,0,0,10213,99071,0,2,10213,99073,California
Los Angeles,2020-12-29,11476,110540,6040,95200,5436,15340,0,0,11478,110549,0,2,11478,110551,California
Los Angeles,2020-12-30,14785,125325,8067,103267,6718,22058,0,0,14784,125333,0,2,14784,125335,California
Los Angeles,2020-12-31,7781,133106,2736,106003,5045,27103,0,0,7779,133111,1,3,7779,133114,California
Los Angeles,2021-01-01,867,133973,215,106218,652,27755,0,0,867,133978,0,3,867,133981,California
Los Angeles,2021-01-02,4366,138339,1628,107846,2738,30493,0,0,4366,138344,0,3,4366,138347,California
Los Angeles,2021-01-03,900,139239,195,108041,705,31198,0,0,900,139244,0,3,900,139247,California
Los Angeles,2021-01-04,12580,151819,4821,112862,7759,38957,0,0,12565,151806,3,6,12565,151812,California
Los Angeles,2021-01-05,15886,167705,7036,119898,8850,47807,0,0,13985,163926,1868,1874,13988,165800,California
Los Angeles,2021-01-06,22256,189961,11997,131895,10259,58066,0,0,16693,175133,5495,7369,16702,182502,California
Los Angeles,2021-01-07,29212,219173,15732,147627,13480,71546,0,0,18756,183489,10413,17782,18769,201271,California
Los Angeles,2021-01-08,32861,252034,17812,165439,15049,86595,0,0,20702,192074,12137,29919,20722,221993,California
Los Angeles,2021-01-09,12284,264318,7023,172462,5261,91856,0,0,7429,194657,4854,34773,7437,229430,California
Los Angeles,2021-01-10,4611,268929,3616,176078,995,92851,0,0,1885,193820,2726,37499,1889,231319,California
Los Angeles,2021-01-11,25564,294493,16144,192222,9420,102271,0,0,14677,197626,10880,48379,14686,246005,California
Los Angeles,2021-01-12,28866,323359,15979,208201,12887,115158,0,0,18804,206387,10046,58425,18807,264812,California
Los Angeles,2021-01-13,28983,352342,15551,223752,13432,128590,0,0,20072,217572,8894,67319,20079,284891,California
Los Angeles,2021-01-14,28979,381321,12643,236395,16336,144926,0,0,23512,235643,5451,72770,23522,308413,California
Los Angeles,2021-01-15,33457,414778,12243,248638,21214,166140,0,0,29920,262058,3512,76282,29927,338340,California
Los Angeles,2021-01-16,17076,431854,4936,253574,12140,178280,0,0,15302,275598,1765,78047,15305,353645,California
Los Angeles,2021-01-17,5134,436988,2269,255843,2865,181145,0,0,4891,280248,243,78290,4893,358538,California
Los Angeles,2021-01-18,15337,452325,9945,265788,5392,186537,0,0,10643,286211,4683,82973,10646,369184,California
Los Angeles,2021-01-19,38091,490416,20313,286101,17778,204315,0,0,30366,308907,7685,90658,30381,399565,California
Los Angeles,2021-01-20,45248,535664,23588,309689,21660,225975,0,0,37791,339277,7426,98084,37796,437361,California
Los Angeles,2021-01-21,48215,583879,22222,331911,25993,251968,0,0,43983,379097,4173,102257,43993,481354,California
Los Angeles,2021-01-22,47407,631286,22126,354037,25281,277249,0,0,44016,419769,3350,105607,44022,525376,California
Los Angeles,2021-01-23,33718,665004,15618,369655,18100,295349,0,0,31724,449534,1965,107572,31730,557106,California
Los Angeles,2021-01-24,15663,680667,12155,381810,3508,298857,0,0,15121,464124,535,108107,15125,572231,California
Los Angeles,2021-01-25,38162,718829,16218,398028,21944,320801,0,0,29795,485618,8334,116441,29828,602059,California
Los Angeles,2021-01-26,48619,767448,24099,422127,24520,345321,0,0,40570,518181,8019,124460,40582,642641,California
Los Angeles,2021-01-27,47804,815252,25487,447614,22317,367638,0,0,38766,548053,8905,133365,38777,681418,California
Los Angeles,2021-01-28,47808,863060,22628,470242,25180,392818,0,0,39617,579593,8084,141449,39624,721042,California
Los Angeles,2021-01-29,48583,911643,25100,495342,23483,416301,0,0,38752,608825,9531,150980,38763,759805,California
Los Angeles,2021-01-30,29657,941300,15157,510499,14500,430801,0,0,25657,630562,3927,154907,25664,785469,California
Los Angeles,2021-01-31,12931,954231,10291,520790,2640,433441,0,0,12028,641701,892,155799,12031,797500,California
Los Angeles,2021-02-01,37431,991662,15856,536646,21575,455016,0,0,27332,658971,10073,165872,27343,824843,California
Los Angeles,2021-02-02,43677,1035339,17668,554314,26009,481025,0,0,31655,678642,11987,177859,31658,856501,California
Los Angeles,2021-02-03,51608,1086947,19275,573589,32333,513358,0,0,37070,701408,14310,192169,37076,893577,California
Los Angeles,2021-02-04,56817,1143764,20510,594099,36307,549665,0,0,38880,722664,17629,209798,38885,932462,California
Los Angeles,2021-02-05,60494,1204258,20777,614876,39717,589382,0,0,38941,740464,21144,230942,38944,971406,California
Los Angeles,2021-02-06,35108,1239366,13059,627935,22049,611431,0,0,26804,759043,8232,239174,26811,998217,California
Los Angeles,2021-02-07,10722,1250088,8276,636211,2446,613877,0,0,8419,765175,2288,241462,8420,1006637,California
Los Angeles,2021-02-08,46103,1296191,21186,657397,24917,638794,0,0,30274,779748,15703,257165,30276,1036913,California
Los Angeles,2021-02-09,54578,1350769,23992,681389,30586,669380,0,0,28184,781590,26347,283512,28189,1065102,California
Los Angeles,2021-02-10,66139,1416908,29054,710443,37085,706465,0,0,30701,777205,35090,318602,30705,1095807,California
Los Angeles,2021-02-11,56498,1473406,30343,740786,26155,732620,0,0,27030,775204,29035,347637,27034,1122841,California
Los Angeles,2021-02-12,58889,1532295,29516,770302,29373,761993,0,0,25680,768008,32887,380524,25691,1148532,California
Los Angeles,2021-02-13,33487,1565782,19472,789774,14015,776008,0,0,15685,765964,17737,398261,15693,1164225,California
Los Angeles,2021-02-14,21770,1587552,14933,804707,6837,782845,0,0,8794,761840,12925,411186,8801,1173026,California
Los Angeles,2021-02-15,31633,1619185,15357,820064,16276,799121,0,0,17253,764757,14339,425525,17256,1190282,California
Los Angeles,2021-02-16,61459,1680644,31526,851590,29933,829054,0,0,28779,760938,32611,458136,28792,1219074,California
Los Angeles,2021-02-17,61209,1741853,32947,884537,28262,857316,0,0,25041,749952,36033,494169,25047,1244121,California
Los Angeles,2021-02-18,62993,1804846,31068,915605,31925,889241,0,0,25976,739132,36806,530975,25986,1270107,California
Los Angeles,2021-02-19,54362,1859208,33349,948954,21013,910254,0,0,27394,739659,26889,557864,27416,1297523,California
Los Angeles,2021-02-20,28921,1888129,22954,971908,5967,916221,0,0,13354,737473,15543,573407,13357,1310880,California
Los Angeles,2021-02-21,14272,1902401,12705,984613,1567,917788,0,0,7561,738337,6699,580106,7563,1318443,California
Los Angeles,2021-02-22,32918,1935319,23862,1008475,9056,926844,0,0,17116,739722,15747,595853,17132,1335575,California
Los Angeles,2021-02-23,51737,1987056,21935,1030410,29802,956646,0,0,20330,728754,31320,627173,20352,1355927,California
Los Angeles,2021-02-24,60718,2047774,26391,1056801,34327,990973,0,0,26813,721797,33779,660952,26822,1382749,California
Los Angeles,2021-02-25,69782,2117556,32408,1089209,37374,1028347,0,0,36493,725157,33150,694102,36510,1419259,California
Los Angeles,2021-02-26,78979,2196535,37188,1126397,41791,1070138,0,0,45343,737071,33445,727547,45359,1464618,California
Los Angeles,2021-02-27,57461,2253996,24434,1150831,33027,1103165,0,0,29619,738989,27719,755266,29637,1494255,California
Los Angeles,2021-02-28,25414,2279410,18020,1168851,7394,1110559,0,0,17783,749188,7588,762854,17787,1512042,California
Los Angeles,2021-03-01,52716,2332126,29820,1198671,22894,1133453,2,2,31874,760338,20738,783592,31888,1543930,California
Los Angeles,2021-03-02,67064,2399190,29674,1228345,37389,1170842,1,3,41049,775484,25916,809508,41062,1584992,California
Los Angeles,2021-03-03,76398,2475588,38571,1266916,37827,1208669,0,3,47358,793964,28912,838420,47392,1632384,California
Los Angeles,2021-03-04,80963,2556551,42866,1309782,38092,1246761,5,8,51954,817088,28844,867264,51968,1684352,California
Los Angeles,2021-03-05,75762,2632313,37709,1347491,38033,1284794,20,28,51722,844953,23896,891160,51761,1736113,California
Los Angeles,2021-03-06,58020,2690333,30071,1377562,26198,1310992,1751,1779,38187,865184,19719,910879,39950,1776063,California
Los Angeles,2021-03-07,23447,2713780,18462,1396024,4235,1315227,750,2529,18571,879644,4863,915742,19323,1795386,California
Los Angeles,2021-03-08,43723,2757503,23512,1419536,18896,1334123,1315,3844,33888,905069,9790,925532,35215,1830601,California
Los Angeles,2021-03-09,62050,2819553,23352,1442888,36395,1370518,2303,6147,37138,919681,24841,950373,39453,1870054,California
Los Angeles,2021-03-10,70803,2890356,35328,1478216,32331,1402849,3144,9291,44855,941844,25838,976211,48001,1918055,California
Los Angeles,2021-03-11,79502,2969858,39395,1517611,35469,1438318,4638,13929,46748,960621,32650,1008861,51427,1969482,California
Los Angeles,2021-03-12,69026,3038884,34490,1552101,29713,1468031,4823,18752,43481,983451,25472,1034333,48302,2017784,California
Los Angeles,2021-03-13,50772,3089656,28490,1580591,18437,1486468,3845,22597,33134,1002841,17594,1051927,36984,2054768,California
Los Angeles,2021-03-14,32101,3121757,22798,1603389,7041,1493509,2262,24859,22504,1018050,9564,1061491,24773,2079541,California
Los Angeles,2021-03-15,68050,3189807,34013,1637402,29189,1522698,4848,29707,41332,1037642,26596,1088087,46188,2125729,California
Los Angeles,2021-03-16,86178,3275985,39796,1677198,41674,1564372,4708,34415,56308,1068925,29746,1117833,61029,2186758,California
Los Angeles,2021-03-17,70584,3346569,35326,1712524,32375,1596747,2883,37298,49852,1101030,20638,1138471,52743,2239501,California
Los Angeles,2021-03-18,56029,3402598,29996,1742520,22997,1619744,3036,40334,33404,1114965,22515,1160986,36450,2275951,California
Los Angeles,2021-03-19,34512,3437110,22566,1765086,10605,1630349,1341,41675,17987,1117843,16468,1177454,19346,2295297,California
Colusa,2020-12-18,1,1,1,1,0,0,0,0,1,1,0,0,1,1,California
Colusa,2020-12-21,2,3,2,3,0,0,0,0,2,3,0,0,2,3,California
Colusa,2020-12-22,10,13,10,13,0,0,0,0,10,13,0,0,10,13,California
Colusa,2020-12-23,10,23,10,23,0,0,0,0,10,23,0,0,10,23,California
Colusa,2020-12-24,2,25,1,24,1,1,0,0,2,25,0,0,2,25,California
Colusa,2020-12-27,1,26,1,25,0,1,0,0,1,26,0,0,1,26,California
Colusa,2020-12-28,7,33,3,28,4,5,0,0,7,33,0,0,7,33,California
Colusa,2020-12-29,11,44,7,35,4,9,0,0,11,44,0,0,11,44,California
Colusa,2020-12-30,50,94,13,48,37,46,0,0,50,94,0,0,50,94,California
Colusa,2020-12-31,18,112,1,49,17,63,0,0,18,112,0,0,18,112,California
Colusa,2021-01-04,5,117,0,49,5,68,0,0,5,117,0,0,5,117,California
Colusa,2021-01-05,68,185,1,50,67,135,0,0,68,185,0,0,68,185,California
Colusa,2021-01-06,15,200,9,59,6,141,0,0,15,200,0,0,15,200,California
Colusa,2021-01-07,37,237,4,63,33,174,0,0,36,235,1,1,36,236,California
Colusa,2021-01-08,9,246,7,70,2,176,0,0,8,242,1,2,8,244,California
Colusa,2021-01-09,3,249,1,71,2,178,0,0,3,245,0,2,3,247,California
Colusa,2021-01-10,1,250,0,71,1,179,0,0,1,246,0,2,1,248,California
Colusa,2021-01-11,12,262,6,77,6,185,0,0,7,248,5,7,7,255,California
Colusa,2021-01-12,11,273,9,86,2,187,0,0,6,249,5,12,6,261,California
Colusa,2021-01-13,21,294,13,99,8,195,0,0,13,254,8,20,13,274,California
Colusa,2021-01-14,35,329,28,127,7,202,0,0,33,285,2,22,33,307,California
Colusa,2021-01-15,43,372,5,132,38,240,0,0,41,324,2,24,41,348,California
Colusa,2021-01-16,12,384,1,133,11,251,0,0,11,334,1,25,11,359,California
Colusa,2021-01-17,3,387,2,135,1,252,0,0,2,335,1,26,2,361,California
Colusa,2021-01-18,4,391,0,135,4,256,0,0,4,339,0,26,4,365,California
Colusa,2021-01-19,8,399,8,143,0,256,0,0,4,339,4,30,4,369,California
Colusa,2021-01-20,114,513,101,244,13,269,0,0,101,427,13,43,101,470,California
Colusa,2021-01-21,56,569,41,285,15,284,0,0,55,481,1,44,55,525,California
Colusa,2021-01-22,39,608,17,302,22,306,0,0,34,510,5,49,34,559,California
Colusa,2021-01-23,35,643,6,308,29,335,0,0,35,545,0,49,35,594,California
Colusa,2021-01-25,7,650,0,308,7,342,0,0,7,552,0,49,7,601,California
Colusa,2021-01-26,9,659,5,313,4,346,0,0,5,553,4,53,5,606,California
Colusa,2021-01-27,107,766,31,344,76,422,0,0,105,656,2,55,105,711,California
Colusa,2021-01-28,78,844,45,389,33,455,0,0,72,722,6,61,72,783,California
Colusa,2021-01-29,40,884,6,395,34,489,0,0,39,760,1,62,39,822,California
Colusa,2021-01-30,27,911,4,399,23,512,0,0,27,787,0,62,27,849,California
Colusa,2021-01-31,7,918,7,406,0,512,0,0,7,794,0,62,7,856,California
Colusa,2021-02-01,27,945,10,416,17,529,0,0,22,811,5,67,22,878,California
Colusa,2021-02-02,42,987,8,424,34,563,0,0,36,841,6,73,36,914,California
Colusa,2021-02-03,71,1058,10,434,61,624,0,0,60,890,11,84,60,974,California
Colusa,2021-02-04,142,1200,80,514,62,686,0,0,115,978,27,111,115,1089,California
Colusa,2021-02-05,33,1233,8,522,25,711,0,0,30,1005,3,114,30,1119,California
Colusa,2021-02-06,287,1520,8,530,279,990,0,0,276,1270,11,125,276,1395,California
Colusa,2021-02-07,2,1522,1,531,1,991,0,0,0,1268,2,127,0,1395,California
Colusa,2021-02-08,40,1562,5,536,35,1026,0,0,37,1302,3,130,37,1432,California
Colusa,2021-02-09,232,1794,14,550,218,1244,0,0,176,1422,56,186,176,1608,California
Colusa,2021-02-10,115,1909,41,591,74,1318,0,0,71,1450,44,230,72,1680,California
Colusa,2021-02-11,97,2006,36,627,61,1379,0,0,72,1497,25,255,72,1752,California
Colusa,2021-02-12,118,2124,9,636,109,1488,0,0,78,1534,41,296,78,1830,California
Colusa,2021-02-13,60,2184,9,645,51,1539,0,0,52,1578,8,304,52,1882,California
Colusa,2021-02-14,20,2204,8,653,12,1551,0,0,14,1587,5,309,14,1896,California
Colusa,2021-02-15,46,2250,10,663,36,1587,0,0,39,1619,7,316,39,1935,California
Colusa,2021-02-16,67,2317,4,667,63,1650,0,0,66,1684,1,317,66,2001,California
Colusa,2021-02-17,205,2522,143,810,62,1712,0,0,59,1597,146,463,59,2060,California
Colusa,2021-02-18,132,2654,33,843,99,1811,0,0,109,1683,23,486,109,2169,California
Colusa,2021-02-19,152,2806,19,862,133,1944,0,0,126,1783,26,512,126,2295,California
Colusa,2021-02-20,25,2831,5,867,20,1964,0,0,8,1775,17,529,9,2304,California
Colusa,2021-02-21,1,2832,1,868,0,1964,0,0,0,1774,1,530,0,2304,California
Colusa,2021-02-22,41,2873,24,892,17,1981,0,0,27,1787,14,544,27,2331,California
Colusa,2021-02-23,18,2891,4,896,14,1995,0,0,15,1799,3,547,15,2346,California
Colusa,2021-02-24,298,3189,54,950,244,2239,0,0,156,1813,142,689,156,2502,California
Colusa,2021-02-25,95,3284,50,1000,45,2284,0,0,61,1840,34,723,61,2563,California
Colusa,2021-02-26,95,3379,11,1011,84,2368,0,0,56,1857,39,762,56,2619,California
Colusa,2021-02-27,55,3434,4,1015,51,2419,0,0,40,1882,15,777,40,2659,California
Colusa,2021-02-28,24,3458,14,1029,10,2429,0,0,15,1888,9,786,15,2674,California
Colusa,2021-03-01,43,3501,14,1043,29,2458,0,0,27,1899,16,802,27,2701,California
Colusa,2021-03-02,45,3546,11,1054,34,2492,0,0,22,1899,22,824,22,2723,California
Colusa,2021-03-03,211,3757,34,1088,177,2669,0,0,160,2008,51,875,160,2883,California
Colusa,2021-03-04,124,3881,47,1135,77,2746,0,0,74,2032,50,925,74,2957,California
Colusa,2021-03-05,91,3972,19,1154,63,2809,9,9,45,2040,46,971,54,3011,California
Colusa,2021-03-06,246,4218,10,1164,236,3045,0,9,32,1858,214,1185,32,3043,California
Colusa,2021-03-07,8,4226,5,1169,3,3048,0,9,6,1862,2,1187,6,3049,California
Colusa,2021-03-08,80,4306,16,1185,27,3075,37,46,33,1884,47,1234,69,3118,California
Colusa,2021-03-09,253,4559,63,1248,178,3253,12,58,76,1795,177,1411,88,3206,California
Colusa,2021-03-10,232,4791,32,1280,186,3439,14,72,176,1930,55,1466,190,3396,California
Colusa,2021-03-11,399,5190,54,1334,323,3762,22,94,315,2183,84,1550,337,3733,California
Colusa,2021-03-12,90,5280,13,1347,65,3827,12,106,17,2140,73,1623,30,3763,California
Colusa,2021-03-13,56,5336,14,1361,35,3862,7,113,17,2125,39,1662,24,3787,California
Colusa,2021-03-14,11,5347,0,1361,9,3871,2,115,4,2124,7,1669,6,3793,California
Colusa,2021-03-15,69,5416,27,1388,35,3906,7,122,16,2095,53,1722,24,3817,California
Colusa,2021-03-16,182,5598,15,1403,120,4026,47,169,73,2106,109,1831,120,3937,California
Colusa,2021-03-17,148,5746,43,1446,105,4131,0,169,67,2092,81,1912,67,4004,California
Colusa,2021-03-18,204,5950,23,1469,173,4304,8,177,161,2219,43,1955,170,4174,California
Colusa,2021-03-19,29,5979,3,1472,26,4330,0,177,21,2232,8,1963,21,4195,California
Madera,2020-12-16,22,22,22,22,0,0,0,0,22,22,0,0,22,22,California
Madera,2020-12-17,12,34,12,34,0,0,0,0,12,34,0,0,12,34,California
Madera,2020-12-18,60,94,60,94,0,0,0,0,60,94,0,0,60,94,California
Madera,2020-12-19,6,100,6,100,0,0,0,0,6,100,0,0,6,100,California
Madera,2020-12-20,14,114,14,114,0,0,0,0,14,114,0,0,14,114,California
Madera,2020-12-21,63,177,63,177,0,0,0,0,63,177,0,0,63,177,California
Madera,2020-12-22,95,272,94,271,1,1,0,0,95,272,0,0,95,272,California
Madera,2020-12-23,65,337,65,336,0,1,0,0,65,337,0,0,65,337,California
Madera,2020-12-24,43,380,39,375,4,5,0,0,43,380,0,0,43,380,California
Madera,2020-12-26,28,408,26,401,2,7,0,0,28,408,0,0,28,408,California
Madera,2020-12-27,31,439,12,413,19,26,0,0,31,439,0,0,31,439,California
Madera,2020-12-28,104,543,36,449,68,94,0,0,104,543,0,0,104,543,California
Madera,2020-12-29,171,714,37,486,134,228,0,0,171,714,0,0,171,714,California
Madera,2020-12-30,216,930,85,571,131,359,0,0,216,930,0,0,216,930,California
Madera,2020-12-31,203,1133,80,651,123,482,0,0,203,1133,0,0,203,1133,California
Madera,2021-01-02,76,1209,21,672,55,537,0,0,76,1209,0,0,76,1209,California
Madera,2021-01-03,5,1214,5,677,0,537,0,0,5,1214,0,0,5,1214,California
Madera,2021-01-04,128,1342,64,741,64,601,0,0,128,1342,0,0,128,1342,California
Madera,2021-01-05,274,1616,138,879,136,737,0,0,269,1607,5,5,270,1612,California
Madera,2021-01-06,184,1800,27,906,157,894,0,0,164,1752,20,25,165,1777,California
Madera,2021-01-07,337,2137,56,962,281,1175,0,0,317,2049,20,45,317,2094,California
Madera,2021-01-08,411,2548,70,1032,341,1516,0,0,356,2352,54,99,357,2451,California
Madera,2021-01-09,36,2584,13,1045,23,1539,0,0,28,2372,8,107,28,2479,California
Madera,2021-01-10,18,2602,15,1060,3,1542,0,0,5,2364,13,120,5,2484,California
Madera,2021-01-11,224,2826,175,1235,49,1591,0,0,184,2508,40,160,184,2668,California
Madera,2021-01-12,392,3218,159,1394,233,1824,0,0,284,2684,108,268,284,2952,California
Madera,2021-01-13,179,3397,88,1482,91,1915,0,0,125,2755,54,322,125,3077,California
Madera,2021-01-14,555,3952,80,1562,475,2390,0,0,522,3244,33,355,522,3599,California
Madera,2021-01-15,594,4546,158,1720,436,2826,0,0,574,3799,20,375,575,4174,California
Madera,2021-01-16,374,4920,46,1766,328,3154,0,0,345,4115,29,404,345,4519,California
Madera,2021-01-17,325,5245,7,1773,318,3472,0,0,320,4431,5,409,321,4840,California
Madera,2021-01-18,73,5318,57,1830,16,3488,0,0,54,4466,19,428,54,4894,California
Madera,2021-01-19,554,5872,128,1958,426,3914,0,0,527,4967,27,455,528,5422,California
Madera,2021-01-20,232,6104,77,2035,155,4069,0,0,206,5148,25,480,206,5628,California
Madera,2021-01-21,229,6333,126,2161,103,4172,0,0,198,5317,29,509,198,5826,California
Madera,2021-01-22,253,6586,82,2243,171,4343,0,0,240,5544,13,522,240,6066,California
Madera,2021-01-23,102,6688,54,2297,48,4391,0,0,78,5599,24,546,79,6145,California
Madera,2021-01-24,101,6789,81,2378,20,4411,0,0,77,5652,24,570,77,6222,California
Madera,2021-01-25,248,7037,116,2494,132,4543,0,0,135,5674,113,683,135,6357,California
Madera,2021-01-26,477,7514,188,2682,289,4832,0,0,291,5780,185,868,291,6648,California
Madera,2021-01-27,737,8251,62,2744,675,5507,0,0,601,6247,136,1004,603,7251,California
Madera,2021-01-28,533,8784,100,2844,433,5940,0,0,430,6574,103,1107,430,7681,California
Madera,2021-01-29,465,9249,92,2936,373,6313,0,0,408,6925,57,1164,408,8089,California
Madera,2021-01-30,504,9753,16,2952,488,6801,0,0,452,7325,52,1216,452,8541,California
Madera,2021-01-31,9,9762,6,2958,3,6804,0,0,8,7332,1,1217,8,8549,California
Madera,2021-02-01,258,10020,71,3029,187,6991,0,0,201,7478,57,1274,203,8752,California
Madera,2021-02-02,245,10265,83,3112,162,7153,0,0,158,7552,87,1361,161,8913,California
Madera,2021-02-03,582,10847,449,3561,133,7286,0,0,469,7910,111,1472,469,9382,California
Madera,2021-02-04,386,11233,121,3682,265,7551,0,0,112,7749,273,1745,112,9494,California
Madera,2021-02-05,965,12198,296,3978,669,8220,0,0,361,7512,599,2344,362,9856,California
Madera,2021-02-06,357,12555,322,4300,35,8255,0,0,320,7796,36,2380,320,10176,California
Madera,2021-02-07,36,12591,7,4307,29,8284,0,0,31,7822,5,2385,31,10207,California
Madera,2021-02-08,374,12965,301,4608,73,8357,0,0,262,7973,112,2497,263,10470,California
Madera,2021-02-09,474,13439,114,4722,360,8717,0,0,193,7889,278,2775,194,10664,California
Madera,2021-02-10,419,13858,150,4872,269,8986,0,0,319,8108,100,2875,319,10983,California
Madera,2021-02-11,918,14776,299,5171,619,9605,0,0,394,7987,522,3397,401,11384,California
Madera,2021-02-12,823,15599,114,5285,709,10314,0,0,290,7753,529,3926,295,11679,California
Madera,2021-02-13,479,16078,47,5332,432,10746,0,0,135,7547,344,4270,138,11817,California
Madera,2021-02-14,385,16463,76,5408,309,11055,0,0,98,7394,287,4557,134,11951,California
Madera,2021-02-15,228,16691,90,5498,138,11193,0,0,147,7479,81,4638,166,12117,California
Madera,2021-02-16,754,17445,175,5673,579,11772,0,0,216,7161,536,5174,218,12335,California
Madera,2021-02-17,594,18039,263,5936,331,12103,0,0,329,7237,260,5434,336,12671,California
Madera,2021-02-18,1259,19298,523,6459,736,12839,0,0,1097,8173,162,5596,1098,13769,California
Madera,2021-02-19,835,20133,526,6985,309,13148,0,0,691,8762,144,5740,733,14502,California
Madera,2021-02-20,1001,21134,940,7925,61,13209,0,0,960,9686,39,5779,963,15465,California
Madera,2021-02-21,942,22076,813,8738,129,13338,0,0,936,10616,6,5785,936,16401,California
Madera,2021-02-22,903,22979,830,9568,73,13411,0,0,849,11411,54,5839,849,17250,California
Madera,2021-02-23,720,23699,457,10025,263,13674,0,0,511,11717,209,6048,515,17765,California
Madera,2021-02-24,892,24591,298,10323,594,14268,0,0,360,11548,532,6580,363,18128,California
Madera,2021-02-25,998,25589,307,10630,691,14959,0,0,577,11713,420,7000,585,18713,California
Madera,2021-02-26,1027,26616,183,10813,844,15803,0,0,671,12038,354,7354,679,19392,California
Madera,2021-02-27,843,27459,238,11051,605,16408,0,0,341,11976,499,7853,437,19829,California
Madera,2021-02-28,179,27638,29,11080,150,16558,0,0,173,12145,5,7858,174,20003,California
Madera,2021-03-01,357,27995,110,11190,247,16805,0,0,184,12167,172,8030,194,20197,California
Madera,2021-03-02,605,28600,258,11448,347,17152,0,0,495,12557,109,8139,499,20696,California
Madera,2021-03-03,1146,29746,662,12110,484,17636,0,0,763,12940,380,8519,763,21459,California
Madera,2021-03-04,1093,30839,462,12572,631,18267,0,0,850,13554,242,8761,856,22315,California
Madera,2021-03-05,1171,32010,380,12952,779,19046,12,12,940,14277,229,8990,952,23267,California
Madera,2021-03-06,672,32682,499,13451,143,19189,30,42,451,14537,221,9211,481,23748,California
Madera,2021-03-07,139,32821,24,13475,94,19283,21,63,101,14621,38,9249,122,23870,California
Madera,2021-03-08,523,33344,310,13785,163,19446,50,113,257,14663,266,9515,308,24178,California
Madera,2021-03-09,419,33763,151,13936,232,19678,36,149,257,14795,161,9676,293,24471,California
Madera,2021-03-10,1054,34817,486,14422,518,20196,50,199,668,15130,383,10059,718,25189,California
Madera,2021-03-11,1533,36350,769,15191,452,20648,312,511,680,15271,852,10911,993,26182,California
Madera,2021-03-12,1316,37666,713,15904,464,21112,139,650,631,15359,683,11594,771,26953,California
Madera,2021-03-13,1579,39245,1195,17099,202,21314,182,832,630,15226,947,12541,814,27767,California
Madera,2021-03-14,483,39728,409,17508,49,21363,25,857,259,15288,223,12764,285,28052,California
Madera,2021-03-15,710,40438,211,17719,455,21818,44,901,492,15623,217,12981,552,28604,California
Madera,2021-03-16,775,41213,414,18133,315,22133,46,947,609,16115,165,13146,657,29261,California
Madera,2021-03-17,984,42197,599,18732,349,22482,36,983,518,16224,457,13603,566,29827,California
Madera,2021-03-18,1184,43381,462,19194,699,23181,23,1006,595,16263,587,14190,626,30453,California
Madera,2021-03-19,581,43962,185,19379,367,23548,29,1035,325,16370,256,14446,363,30816,California
Kern,2020-12-15,1,1,1,1,0,0,0,0,1,1,0,0,1,1,California
Kern,2020-12-16,18,19,18,19,0,0,0,0,18,19,0,0,18,19,California
Kern,2020-12-17,164,183,164,183,0,0,0,0,164,183,0,0,164,183,California
Kern,2020-12-18,318,501,318,501,0,0,0,0,318,501,0,0,318,501,California
Kern,2020-12-19,100,601,100,601,0,0,0,0,100,601,0,0,100,601,California
Kern,2020-12-20,60,661,60,661,0,0,0,0,60,661,0,0,60,661,California
Kern,2020-12-21,670,1331,670,1331,0,0,0,0,670,1331,0,0,670,1331,California
Kern,2020-12-22,530,1861,527,1858,3,3,0,0,530,1861,0,0,530,1861,California
Kern,2020-12-23,556,2417,417,2275,139,142,0,0,556,2417,0,0,556,2417,California
Kern,2020-12-24,122,2539,43,2318,79,221,0,0,122,2539,0,0,122,2539,California
Kern,2020-12-25,1,2540,1,2319,0,221,0,0,1,2540,0,0,1,2540,California
Kern,2020-12-26,33,2573,1,2320,32,253,0,0,33,2573,0,0,33,2573,California
Kern,2020-12-27,35,2608,3,2323,32,285,0,0,35,2608,0,0,35,2608,California
Kern,2020-12-28,826,3434,662,2985,164,449,0,0,826,3434,0,0,826,3434,California
Kern,2020-12-29,745,4179,452,3437,293,742,0,0,745,4179,0,0,745,4179,California
Kern,2020-12-30,1199,5378,908,4345,291,1033,0,0,1199,5378,0,0,1199,5378,California
Kern,2020-12-31,277,5655,98,4443,179,1212,0,0,277,5655,0,0,277,5655,California
Kern,2021-01-01,9,5664,6,4449,3,1215,0,0,9,5664,0,0,9,5664,California
Kern,2021-01-02,75,5739,16,4465,59,1274,0,0,75,5739,0,0,75,5739,California
Kern,2021-01-03,22,5761,4,4469,18,1292,0,0,22,5761,0,0,22,5761,California
Kern,2021-01-04,554,6315,360,4829,194,1486,0,0,554,6315,0,0,554,6315,California
Kern,2021-01-05,1127,7442,735,5564,392,1878,0,0,1115,7418,12,12,1115,7430,California
Kern,2021-01-06,1164,8606,453,6017,711,2589,0,0,1134,8522,30,42,1134,8564,California
Kern,2021-01-07,1402,10008,494,6511,908,3497,0,0,1233,9587,168,210,1233,9797,California
Kern,2021-01-08,1625,11633,766,7277,859,4356,0,0,1329,10618,298,508,1329,11126,California
Kern,2021-01-09,226,11859,76,7353,150,4506,0,0,192,10776,34,542,192,11318,California
Kern,2021-01-10,190,12049,145,7498,45,4551,0,0,149,10884,41,583,149,11467,California
Kern,2021-01-11,1549,13598,981,8479,568,5119,0,0,999,11333,550,1133,999,12466,California
Kern,2021-01-12,1868,15466,811,9290,1057,6176,0,0,1357,12179,511,1644,1357,13823,California
Kern,2021-01-13,1845,17311,866,10156,979,7155,0,0,1423,13180,422,2066,1423,15246,California
Kern,2021-01-14,2174,19485,643,10799,1531,8686,0,0,2127,15261,47,2113,2128,17374,California
Kern,2021-01-15,2691,22176,858,11657,1833,10519,0,0,2594,17761,95,2208,2595,19969,California
Kern,2021-01-16,658,22834,203,11860,455,10974,0,0,626,18355,32,2240,626,20595,California
Kern,2021-01-17,69,22903,7,11867,62,11036,0,0,67,18420,2,2242,67,20662,California
Kern,2021-01-18,1639,24542,658,12525,981,12017,0,0,1469,19719,170,2412,1469,22131,California
Kern,2021-01-19,1836,26378,1021,13546,815,12832,0,0,1374,20632,462,2874,1375,23506,California
Kern,2021-01-20,2435,28813,1502,15048,933,13765,0,0,1816,21836,614,3488,1818,25324,California
Kern,2021-01-21,2146,30959,914,15962,1232,14997,0,0,1954,23599,191,3679,1954,27278,California
Kern,2021-01-22,2692,33651,1285,17247,1407,16404,0,0,2417,25742,274,3953,2417,29695,California
Kern,2021-01-23,1241,34892,529,17776,712,17116,0,0,1195,26891,46,3999,1195,30890,California
Kern,2021-01-24,161,35053,19,17795,142,17258,0,0,156,27042,5,4004,156,31046,California
Kern,2021-01-25,2373,37426,1080,18875,1293,18551,0,0,1890,28452,482,4486,1892,32938,California
Kern,2021-01-26,2728,40154,1106,19981,1622,20173,0,0,1879,29483,848,5334,1879,34817,California
Kern,2021-01-27,3544,43698,1890,21871,1654,21827,0,0,2847,31634,696,6030,2847,37664,California
Kern,2021-01-28,2822,46520,1328,23199,1494,23321,0,0,2406,33628,413,6443,2407,40071,California
Kern,2021-01-29,3738,50258,1782,24981,1956,25277,0,0,3200,36293,535,6978,3200,43271,California
Kern,2021-01-30,1319,51577,494,25475,825,26102,0,0,1273,37522,44,7022,1273,44544,California
Kern,2021-01-31,400,51977,273,25748,127,26229,0,0,267,37656,133,7155,267,44811,California
Kern,2021-02-01,2399,54376,816,26564,1583,27812,0,0,1851,38961,546,7701,1851,46662,California
Kern,2021-02-02,2903,57279,975,27539,1928,29740,0,0,2047,40153,856,8557,2048,48710,California
Kern,2021-02-03,3648,60927,1542,29081,2106,31846,0,0,2682,41877,959,9516,2683,51393,California
Kern,2021-02-04,3781,64708,1442,30523,2339,34185,0,0,2568,43244,1202,10718,2569,53962,California
Kern,2021-02-05,4823,69531,1978,32501,2845,37030,0,0,3074,44588,1730,12448,3074,57036,California
Kern,2021-02-06,1722,71253,757,33258,965,37995,0,0,1502,45873,217,12665,1502,58538,California
Kern,2021-02-07,280,71533,148,33406,132,38127,0,0,266,46127,12,12677,266,58804,California
Kern,2021-02-08,2553,74086,787,34193,1766,39893,0,0,1255,46102,1280,13957,1255,60059,California
Kern,2021-02-09,3009,77095,979,35172,2030,41923,0,0,1458,46015,1545,15502,1458,61517,California
Kern,2021-02-10,3725,80820,1646,36818,2079,44002,0,0,1893,46093,1816,17318,1894,63411,California
Kern,2021-02-11,4241,85061,1529,38347,2712,46714,0,0,2218,46301,2010,19328,2218,65629,California
Kern,2021-02-12,4907,89968,1852,40199,3055,49769,0,0,2451,46311,2441,21769,2451,68080,California
Kern,2021-02-13,1965,91933,681,40880,1284,51053,0,0,1149,46646,814,22583,1149,69229,California
Kern,2021-02-14,352,92285,13,40893,339,51392,0,0,272,46839,79,22662,272,69501,California
Kern,2021-02-15,2712,94997,884,41777,1828,53220,0,0,1195,46527,1508,24170,1196,70697,California
Kern,2021-02-16,2867,97864,703,42480,2164,55384,0,0,1612,46895,1244,25414,1612,72309,California
Kern,2021-02-17,3987,101851,2054,44534,1933,57317,0,0,1893,46699,2089,27503,1893,74202,California
Kern,2021-02-18,3522,105373,1462,45996,2060,59377,0,0,1478,46145,2032,29535,1478,75680,California
Kern,2021-02-19,4111,109484,1900,47896,2211,61588,0,0,1724,45486,2383,31918,1724,77404,California
Kern,2021-02-20,2365,111849,951,48847,1414,63002,0,0,1140,45406,1221,33139,1141,78545,California
Kern,2021-02-21,202,112051,97,48944,105,63107,0,0,72,45350,128,33267,72,78617,California
Kern,2021-02-22,2589,114640,1132,50076,1457,64564,0,0,1401,45565,1186,34453,1401,80018,California
Kern,2021-02-23,3382,118022,1072,51148,2310,66874,0,0,1890,45967,1490,35943,1892,81910,California
Kern,2021-02-24,4994,123016,2226,53374,2768,69642,0,0,2960,46897,2030,37973,2960,84870,California
Kern,2021-02-25,5075,128091,2397,55771,2678,72320,0,0,2961,47763,2095,40068,2961,87831,California
Kern,2021-02-26,6334,134425,3221,58992,3113,75433,0,0,3996,49427,2332,42400,3996,91827,California
Kern,2021-02-27,3645,138070,1725,60717,1920,77353,0,0,2448,50691,1186,43586,2450,94277,California
Kern,2021-02-28,845,138915,452,61169,393,77746,0,0,651,51149,193,43779,651,94928,California
Kern,2021-03-01,3833,142748,1768,62937,2065,79811,0,0,2581,52485,1246,45025,2582,97510,California
Kern,2021-03-02,4098,146846,1310,64247,2787,82598,1,1,2668,53734,1419,46444,2668,100178,California
Kern,2021-03-03,5437,152283,2594,66841,2842,85440,1,2,3429,55169,1995,48439,3430,103608,California
Kern,2021-03-04,4625,156908,1651,68492,2972,88412,2,4,3273,57104,1341,49780,3276,106884,California
Kern,2021-03-05,5922,162830,2617,71109,3288,91700,17,21,3780,58766,2135,51915,3797,110681,California
Kern,2021-03-06,4238,167068,1859,72968,2285,93985,94,115,3160,60953,1071,52986,3258,113939,California
Kern,2021-03-07,1941,169009,1561,74529,332,94317,48,163,1812,62685,128,53114,1860,115799,California
Kern,2021-03-08,2448,171457,786,75315,1476,95793,186,349,1264,62953,1181,54295,1449,117248,California
Kern,2021-03-09,3286,174743,714,76029,2251,98044,321,670,1994,63977,1289,55584,2313,119561,California
Kern,2021-03-10,5549,180292,2376,78405,2263,100307,910,1580,3214,65777,2325,57909,4125,123686,California
Kern,2021-03-11,5616,185908,2126,80531,2703,103010,787,2367,3376,67706,2234,60143,4163,127849,California
Kern,2021-03-12,6237,192145,2451,82982,2993,106003,793,3160,3621,69510,2608,62751,4412,132261,California
Kern,2021-03-13,3723,195868,2046,85028,1383,107386,294,3454,2492,71067,1229,63980,2786,135047,California
Kern,2021-03-14,1864,197732,1260,86288,424,107810,180,3634,1496,72376,366,64346,1675,136722,California
Kern,2021-03-15,3936,201668,965,87253,2357,110167,614,4248,2044,73146,1888,66234,2658,139380,California
Kern,2021-03-16,4099,205767,919,88172,2682,112849,498,4746,2244,74039,1848,68082,2741,142121,California
Kern,2021-03-17,5968,211735,3133,91305,2464,115313,371,5117,3852,76154,2108,70190,4223,146344,California
Kern,2021-03-18,4461,216196,2734,94039,1410,116723,317,5434,2776,77572,1677,71867,3095,149439,California
Kern,2021-03-19,4010,220206,2459,96498,1293,118016,258,5692,1942,77709,2065,73932,2202,151641,California
Unknown,2020-12-17,37,37,37,37,0,0,0,0,1,1,0,0,1,1,Not in California
Unknown,2020-12-18,52,89,52,89,0,0,0,0,2,3,0,0,2,3,Not in California
Unknown,2020-12-21,41,130,41,130,0,0,0,0,0,3,0,0,0,3,Not in California
Unknown,2020-12-22,2,132,2,132,0,0,0,0,2,5,0,0,2,5,Not in California
Unknown,2020-12-24,2,134,2,134,0,0,0,0,2,7,0,0,2,7,Not in California
Unknown,2020-12-28,3,137,3,137,0,0,0,0,3,10,0,0,3,10,Not in California
Unknown,2020-12-29,3,140,3,140,0,0,0,0,3,13,0,0,3,13,Not in California
Unknown,2020-12-30,55,195,55,195,0,0,0,0,55,68,0,0,55,68,Not in California
Unknown,2020-12-31,2,197,0,195,2,2,0,0,0,68,0,0,0,68,Not in California
Unknown,2021-01-02,2,199,0,195,2,4,0,0,2,70,0,0,2,70,Not in California
Unknown,2021-01-03,1,200,0,195,1,5,0,0,1,71,0,0,1,71,Not in California
Unknown,2021-01-04,3,203,2,197,1,6,0,0,3,74,0,0,3,74,Not in California
Unknown,2021-01-05,4,207,0,197,4,10,0,0,4,78,0,0,4,78,Not in California
Unknown,2021-01-06,6,213,2,199,4,14,0,0,6,84,0,0,6,84,Not in California
Unknown,2021-01-07,70,283,68,267,2,16,0,0,70,154,0,0,70,154,Not in California
Unknown,2021-01-09,4,287,2,269,2,18,0,0,4,158,0,0,4,158,Not in California
Unknown,2021-01-10,1,288,0,269,1,19,0,0,1,159,0,0,1,159,Not in California
Unknown,2021-01-11,19,307,19,288,0,19,0,0,18,177,0,0,18,177,Not in California
Unknown,2021-01-12,11,318,10,298,1,20,0,0,7,182,3,3,8,185,Not in California
Unknown,2021-01-13,11,329,11,309,0,20,0,0,12,194,0,3,12,197,Not in California
Unknown,2021-01-14,4,333,4,313,0,20,0,0,2,194,2,5,2,199,Not in California
Unknown,2021-01-15,4,337,3,316,1,21,0,0,5,199,0,5,5,204,Not in California
Unknown,2021-01-16,7,344,7,323,0,21,0,0,7,206,0,5,7,211,Not in California
Unknown,2021-01-17,3,347,3,326,0,21,0,0,3,209,0,5,3,214,Not in California
Unknown,2021-01-18,58,405,58,384,0,21,0,0,56,263,2,7,56,270,Not in California
Unknown,2021-01-19,25,430,25,409,0,21,0,0,23,285,1,8,23,293,Not in California
Unknown,2021-01-20,80,510,80,489,0,21,0,0,28,261,52,60,28,321,Not in California
Unknown,2021-01-21,64,574,58,547,6,27,0,0,66,327,0,60,66,387,Not in California
Unknown,2021-01-22,45,619,37,584,8,35,0,0,44,371,0,60,44,431,Not in California
Unknown,2021-01-23,13,632,7,591,6,41,0,0,13,384,0,60,13,444,Not in California
Unknown,2021-01-24,6,638,6,597,0,41,0,0,7,391,0,60,7,451,Not in California
Unknown,2021-01-25,23,661,21,618,2,43,0,0,21,410,2,62,21,472,Not in California
Unknown,2021-01-26,95,756,95,713,0,43,0,0,97,507,1,63,98,570,Not in California
Unknown,2021-01-27,24,780,24,737,0,43,0,0,23,529,1,64,23,593,Not in California
Unknown,2021-01-28,163,943,160,897,3,46,0,0,107,576,60,124,107,700,Not in California
Unknown,2021-01-29,162,1105,161,1058,1,47,0,0,166,740,2,126,166,866,Not in California
Unknown,2021-01-30,12,1117,8,1066,4,51,0,0,14,752,2,128,14,880,Not in California
Unknown,2021-01-31,23,1140,22,1088,1,52,0,0,22,772,2,130,22,902,Not in California
Unknown,2021-02-01,40,1180,39,1127,1,53,0,0,25,780,17,147,25,927,Not in California
Unknown,2021-02-02,77,1257,76,1203,1,54,0,0,70,844,6,153,70,997,Not in California
Unknown,2021-02-03,54,1311,52,1255,2,56,0,0,43,875,12,165,43,1040,Not in California
Unknown,2021-02-04,69,1380,62,1317,7,63,0,0,65,933,7,172,65,1105,Not in California
Unknown,2021-02-05,15,1395,9,1326,6,69,0,0,14,941,6,178,14,1119,Not in California
Unknown,2021-02-06,18,1413,14,1340,4,73,0,0,16,951,6,184,16,1135,Not in California
Unknown,2021-02-07,13,1426,11,1351,2,75,0,0,9,956,4,188,9,1144,Not in California
Unknown,2021-02-08,60,1486,57,1408,3,78,0,0,19,932,43,231,19,1163,Not in California
Unknown,2021-02-09,23,1509,22,1430,1,79,0,0,7,923,16,247,7,1170,Not in California
Unknown,2021-02-10,38,1547,33,1463,5,84,0,0,12,909,26,273,12,1182,Not in California
Unknown,2021-02-11,98,1645,95,1558,3,87,0,0,47,904,52,325,47,1229,Not in California
Unknown,2021-02-12,49,1694,40,1598,9,96,0,0,20,890,34,359,20,1249,Not in California
Unknown,2021-02-13,12,1706,4,1602,8,104,0,0,15,904,1,360,15,1264,Not in California
Unknown,2021-02-14,10,1716,3,1605,7,111,0,0,7,908,3,363,7,1271,Not in California
Unknown,2021-02-15,46,1762,40,1645,6,117,0,0,31,926,13,376,31,1302,Not in California
Unknown,2021-02-16,112,1874,104,1749,8,125,0,0,40,894,72,448,40,1342,Not in California
Unknown,2021-02-17,15,1889,13,1762,2,127,0,0,6,892,8,456,6,1348,Not in California
Unknown,2021-02-18,119,2008,112,1874,7,134,0,0,30,833,89,545,30,1378,Not in California
Unknown,2021-02-19,217,2225,210,2084,7,141,0,0,66,747,152,697,66,1444,Not in California
Unknown,2021-02-20,11,2236,4,2088,7,148,0,0,7,750,4,701,7,1451,Not in California
Unknown,2021-02-21,13,2249,13,2101,0,148,0,0,6,747,9,710,6,1457,Not in California
Unknown,2021-02-22,11,2260,11,2112,0,148,0,0,6,748,5,715,6,1463,Not in California
Unknown,2021-02-23,76,2336,64,2176,12,160,0,0,21,714,55,770,21,1484,Not in California
Unknown,2021-02-24,47,2383,39,2215,8,168,0,0,18,702,30,800,18,1502,Not in California
Unknown,2021-02-25,82,2465,70,2285,12,180,0,0,30,680,52,852,30,1532,Not in California
Unknown,2021-02-26,33,2498,20,2305,13,193,0,0,20,688,12,864,20,1552,Not in California
Unknown,2021-02-27,26,2524,13,2318,13,206,0,0,18,698,8,872,18,1570,Not in California
Unknown,2021-02-28,23,2547,18,2336,5,211,0,0,17,710,6,878,18,1588,Not in California
Unknown,2021-03-01,45,2592,32,2368,13,224,0,0,24,713,21,899,24,1612,Not in California
Unknown,2021-03-02,17,2609,5,2373,12,236,0,0,11,718,6,905,11,1623,Not in California
Unknown,2021-03-03,17,2626,9,2382,8,244,0,0,13,727,4,909,13,1636,Not in California
Unknown,2021-03-04,51,2677,48,2430,3,247,0,0,17,710,34,943,17,1653,Not in California
Unknown,2021-03-05,179,2856,62,2492,117,364,0,0,172,875,7,950,172,1825,Not in California
Unknown,2021-03-06,204,3060,45,2537,120,484,39,39,155,1020,49,999,194,2019,Not in California
Unknown,2021-03-07,72,3132,31,2568,27,511,14,53,55,1072,17,1016,69,2088,Not in California
Unknown,2021-03-08,174,3306,81,2649,54,565,39,92,112,1161,62,1078,151,2239,Not in California
Unknown,2021-03-09,179,3485,115,2764,9,574,55,147,92,1222,86,1164,147,2386,Not in California
Unknown,2021-03-10,174,3659,117,2881,4,578,53,200,114,1329,60,1224,167,2553,Not in California
Unknown,2021-03-11,151,3810,77,2958,9,587,65,265,76,1396,74,1298,141,2694,Not in California
Unknown,2021-03-12,113,3923,65,3023,23,610,25,290,50,1410,63,1361,77,2771,Not in California
Unknown,2021-03-13,95,4018,30,3053,22,632,43,333,45,1449,49,1410,88,2859,Not in California
Unknown,2021-03-14,117,4135,57,3110,35,667,25,358,83,1523,34,1444,108,2967,Not in California
Unknown,2021-03-15,257,4392,149,3259,90,757,18,376,223,1730,34,1478,241,3208,Not in California
Unknown,2021-03-16,288,4680,194,3453,93,850,1,377,264,1971,24,1502,265,3473,Not in California
Unknown,2021-03-17,220,4900,139,3592,79,929,2,379,213,2179,7,1509,215,3688,Not in California
Unknown,2021-03-18,62,4962,36,3628,25,954,1,380,56,2230,6,1515,57,3745,Not in California
Unknown,2021-03-19,2,4964,0,3628,2,956,0,380,2,2232,0,1515,2,3747,Not in California
Merced,2020-12-16,3,3,3,3,0,0,0,0,3,3,0,0,3,3,California
Merced,2020-12-17,6,9,6,9,0,0,0,0,6,9,0,0,6,9,California
Merced,2020-12-18,145,154,145,154,0,0,0,0,145,154,0,0,145,154,California
Merced,2020-12-19,38,192,38,192,0,0,0,0,38,192,0,0,38,192,California
Merced,2020-12-20,18,210,17,209,1,1,0,0,18,210,0,0,18,210,California
Merced,2020-12-21,129,339,126,335,3,4,0,0,129,339,0,0,129,339,California
Merced,2020-12-22,162,501,162,497,0,4,0,0,162,501,0,0,162,501,California
Merced,2020-12-23,303,804,288,785,15,19,0,0,303,804,0,0,303,804,California
Merced,2020-12-24,70,874,70,855,0,19,0,0,70,874,0,0,70,874,California
Merced,2020-12-25,5,879,5,860,0,19,0,0,5,879,0,0,5,879,California
Merced,2020-12-26,7,886,4,864,3,22,0,0,7,886,0,0,7,886,California
Merced,2020-12-27,12,898,11,875,1,23,0,0,12,898,0,0,12,898,California
Merced,2020-12-28,126,1024,100,975,26,49,0,0,126,1024,0,0,126,1024,California
Merced,2020-12-29,190,1214,135,1110,55,104,0,0,190,1214,0,0,190,1214,California
Merced,2020-12-30,239,1453,93,1203,146,250,0,0,237,1451,0,0,237,1451,California
Merced,2020-12-31,127,1580,39,1242,88,338,0,0,124,1575,0,0,124,1575,California
Merced,2021-01-02,127,1707,116,1358,11,349,0,0,128,1703,0,0,128,1703,California
Merced,2021-01-03,9,1716,5,1363,4,353,0,0,9,1712,0,0,9,1712,California
Merced,2021-01-04,83,1799,40,1403,43,396,0,0,83,1795,0,0,83,1795,California
Merced,2021-01-05,317,2116,228,1631,89,485,0,0,319,2110,5,5,320,2115,California
Merced,2021-01-06,272,2388,98,1729,174,659,0,0,266,2371,6,11,267,2382,California
Merced,2021-01-07,192,2580,80,1809,112,771,0,0,191,2550,12,23,191,2573,California
Merced,2021-01-08,543,3123,400,2209,143,914,0,0,398,2799,150,173,399,2972,California
Merced,2021-01-09,24,3147,11,2220,13,927,0,0,18,2811,6,179,18,2990,California
Merced,2021-01-10,10,3157,6,2226,4,931,0,0,6,2813,4,183,6,2996,California
Merced,2021-01-11,244,3401,171,2397,73,1004,0,0,118,2807,124,307,118,3114,California
Merced,2021-01-12,309,3710,162,2559,147,1151,0,0,255,3005,57,364,255,3369,California
Merced,2021-01-13,453,4163,234,2793,219,1370,0,0,240,3039,207,571,241,3610,California
Merced,2021-01-14,354,4517,213,3006,141,1511,0,0,184,3056,169,740,186,3796,California
Merced,2021-01-15,681,5198,147,3153,534,2045,0,0,659,3678,39,779,661,4457,California
Merced,2021-01-16,239,5437,152,3305,87,2132,0,0,234,3907,5,784,234,4691,California
Merced,2021-01-17,48,5485,11,3316,37,2169,0,0,47,3953,1,785,47,4738,California
Merced,2021-01-18,334,5819,158,3474,176,2345,0,0,312,4246,22,807,315,5053,California
Merced,2021-01-19,740,6559,586,4060,154,2499,0,0,558,4625,182,989,561,5614,California
Merced,2021-01-20,593,7152,487,4547,106,2605,0,0,530,5093,63,1052,531,6145,California
Merced,2021-01-21,1057,8209,686,5233,371,2976,0,0,957,5952,101,1153,960,7105,California
Merced,2021-01-22,1389,9598,714,5947,675,3651,0,0,1368,7308,23,1176,1379,8484,California
Merced,2021-01-23,308,9906,184,6131,124,3775,0,0,204,7407,105,1281,204,8688,California
Merced,2021-01-24,33,9939,16,6147,17,3792,0,0,23,7421,9,1290,23,8711,California
Merced,2021-01-25,779,10718,267,6414,512,4304,0,0,705,8068,58,1348,705,9416,California
Merced,2021-01-26,940,11658,478,6892,462,4766,0,0,686,8550,208,1556,690,10106,California
Merced,2021-01-27,1027,12685,582,7474,445,5211,0,0,837,9227,163,1719,840,10946,California
Merced,2021-01-28,1199,13884,582,8056,617,5828,0,0,1042,10137,133,1852,1043,11989,California
Merced,2021-01-29,906,14790,333,8389,573,6401,0,0,651,10549,242,2094,654,12643,California
Merced,2021-01-30,285,15075,25,8414,260,6661,0,0,262,10796,23,2117,270,12913,California
Merced,2021-01-31,48,15123,12,8426,36,6697,0,0,45,10838,3,2120,45,12958,California
Merced,2021-02-01,373,15496,51,8477,322,7019,0,0,309,11098,64,2184,324,13282,California
Merced,2021-02-02,302,15798,184,8661,118,7137,0,0,183,11164,118,2302,184,13466,California
Merced,2021-02-03,400,16198,73,8734,327,7464,0,0,204,11172,196,2498,204,13670,California
Merced,2021-02-04,433,16631,158,8892,275,7739,0,0,279,11301,151,2649,280,13950,California
Merced,2021-02-05,632,17263,219,9111,413,8152,0,0,326,11336,292,2941,327,14277,California
Merced,2021-02-06,442,17705,249,9360,193,8345,0,0,271,11439,170,3111,273,14550,California
Merced,2021-02-07,19,17724,12,9372,7,8352,0,0,12,11444,7,3118,12,14562,California
Merced,2021-02-08,317,18041,223,9595,94,8446,0,0,179,11487,137,3255,180,14742,California
Merced,2021-02-09,1236,19277,938,10533,298,8744,0,0,774,11899,455,3710,867,15609,California
Merced,2021-02-10,1920,21197,1444,11977,476,9220,0,0,1334,12685,582,4292,1368,16977,California
Merced,2021-02-11,2601,23798,2049,14026,552,9772,0,0,1848,13789,748,5040,1852,18829,California
Merced,2021-02-12,1879,25677,1063,15089,816,10588,0,0,824,13574,1043,6083,828,19657,California
Merced,2021-02-13,363,26040,205,15294,158,10746,0,0,269,13749,95,6178,270,19927,California
Merced,2021-02-14,113,26153,26,15320,87,10833,0,0,92,13823,21,6199,95,20022,California
Merced,2021-02-15,270,26423,39,15359,231,11064,0,0,167,13891,100,6299,168,20190,California
Merced,2021-02-16,1279,27702,860,16219,419,11483,0,0,765,14248,496,6795,853,21043,California
Merced,2021-02-17,1943,29645,1679,17898,264,11747,0,0,1350,15038,581,7376,1371,22414,California
Merced,2021-02-18,1308,30953,845,18743,463,12210,0,0,439,14652,845,8221,459,22873,California
Merced,2021-02-19,1291,32244,417,19160,874,13084,0,0,548,14477,738,8959,563,23436,California
Merced,2021-02-20,254,32498,28,19188,226,13310,0,0,129,14486,121,9080,130,23566,California
Merced,2021-02-21,69,32567,55,19243,14,13324,0,0,24,14466,45,9125,25,23591,California
Merced,2021-02-22,910,33477,364,19607,546,13870,0,0,561,14682,347,9472,563,24154,California
Merced,2021-02-23,1177,34654,487,20094,690,14560,0,0,683,14931,490,9962,739,24893,California
Merced,2021-02-24,831,35485,287,20381,544,15104,0,0,449,15005,378,10340,452,25345,California
Merced,2021-02-25,1791,37276,835,21216,956,16060,0,0,1323,15868,464,10804,1327,26672,California
Merced,2021-02-26,2317,39593,1496,22712,821,16881,0,0,1874,17311,438,11242,1881,28553,California
Merced,2021-02-27,2431,42024,887,23599,1543,18424,1,1,2118,19123,311,11553,2123,30676,California
Merced,2021-02-28,309,42333,62,23661,247,18671,0,1,261,19339,46,11599,262,30938,California
Merced,2021-03-01,1189,43522,276,23937,913,19584,0,1,841,19842,341,11940,844,31782,California
Merced,2021-03-02,1739,45261,907,24844,832,20416,0,1,1352,20814,382,12322,1354,33136,California
Merced,2021-03-03,2252,47513,1757,26601,494,20910,1,2,1480,21535,764,13086,1485,34621,California
Merced,2021-03-04,2938,50451,2305,28906,632,21542,1,3,1955,22527,972,14058,1964,36585,California
Merced,2021-03-05,2399,52850,1506,30412,867,22409,26,29,1802,23783,588,14646,1844,38429,California
Merced,2021-03-06,989,53839,470,30882,499,22908,20,49,715,24248,272,14918,737,39166,California
Merced,2021-03-07,249,54088,55,30937,170,23078,24,73,220,24463,29,14947,244,39410,California
Merced,2021-03-08,1100,55188,507,31444,531,23609,62,135,903,25233,197,15144,967,40377,California
Merced,2021-03-09,1654,56842,954,32398,588,24197,112,247,1039,25778,609,15753,1154,41531,California
Merced,2021-03-10,2908,59750,2013,34411,681,24878,214,461,1787,26678,1110,16863,2010,43541,California
Merced,2021-03-11,1886,61636,611,35022,1078,25956,197,658,1322,27642,557,17420,1521,45062,California
Merced,2021-03-12,2336,63972,1027,36049,1055,27011,254,912,1575,28750,757,18177,1865,46927,California
Merced,2021-03-13,613,64585,262,36311,115,27126,236,1148,299,28987,312,18489,549,47476,California
Merced,2021-03-14,167,64752,96,36407,42,27168,29,1177,98,29046,69,18558,128,47604,California
Merced,2021-03-15,1477,66229,486,36893,739,27907,252,1429,956,29750,513,19071,1217,48821,California
Merced,2021-03-16,1482,67711,775,37668,493,28400,214,1643,1008,30505,467,19538,1222,50043,California
Merced,2021-03-17,2004,69715,1240,38908,593,28993,171,1814,1577,31836,420,19958,1751,51794,California
Merced,2021-03-18,1479,71194,828,39736,537,29530,114,1928,1024,32541,452,20410,1157,52951,California
Merced,2021-03-19,980,72174,253,39989,644,30174,83,2011,752,33156,222,20632,837,53788,California
Merced,2021-03-20,7,72181,7,39996,0,30174,0,2011,6,33161,1,20633,6,53794,California
Marin,2020-12-15,2,2,2,2,0,0,0,0,2,2,0,0,2,2,California
Marin,2020-12-16,107,109,107,109,0,0,0,0,107,109,0,0,107,109,California
Marin,2020-12-17,259,368,259,368,0,0,0,0,259,368,0,0,259,368,California
Marin,2020-12-18,372,740,372,740,0,0,0,0,372,740,0,0,372,740,California
Marin,2020-12-19,347,1087,347,1087,0,0,0,0,347,1087,0,0,347,1087,California
Marin,2020-12-20,166,1253,165,1252,1,1,0,0,166,1253,0,0,166,1253,California
Marin,2020-12-21,238,1491,235,1487,3,4,0,0,238,1491,0,0,238,1491,California
Marin,2020-12-22,517,2008,315,1802,202,206,0,0,517,2008,0,0,517,2008,California
Marin,2020-12-23,731,2739,323,2125,408,614,0,0,731,2739,0,0,731,2739,California
Marin,2020-12-24,356,3095,160,2285,196,810,0,0,356,3095,0,0,356,3095,California
Marin,2020-12-25,27,3122,0,2285,27,837,0,0,27,3122,0,0,27,3122,California
Marin,2020-12-26,140,3262,92,2377,48,885,0,0,140,3262,0,0,140,3262,California
Marin,2020-12-27,93,3355,56,2433,37,922,0,0,93,3355,0,0,93,3355,California
Marin,2020-12-28,406,3761,99,2532,307,1229,0,0,406,3761,0,0,406,3761,California
Marin,2020-12-29,397,4158,86,2618,311,1540,0,0,397,4158,0,0,397,4158,California
Marin,2020-12-30,624,4782,387,3005,237,1777,0,0,624,4782,0,0,624,4782,California
Marin,2020-12-31,198,4980,33,3038,165,1942,0,0,198,4980,0,0,198,4980,California
Marin,2021-01-01,5,4985,3,3041,2,1944,0,0,5,4985,0,0,5,4985,California
Marin,2021-01-02,102,5087,97,3138,5,1949,0,0,102,5087,0,0,102,5087,California
Marin,2021-01-03,55,5142,37,3175,18,1967,0,0,52,5139,0,0,52,5139,California
Marin,2021-01-04,285,5427,184,3359,101,2068,0,0,284,5422,1,1,284,5423,California
Marin,2021-01-05,365,5792,223,3582,142,2210,0,0,322,5701,43,44,322,5745,California
Marin,2021-01-06,820,6612,316,3898,504,2714,0,0,643,6168,176,220,643,6388,California
Marin,2021-01-07,890,7502,501,4399,389,3103,0,0,544,6366,346,566,544,6932,California
Marin,2021-01-08,966,8468,509,4908,457,3560,0,0,593,6587,372,938,593,7525,California
Marin,2021-01-09,616,9084,220,5128,396,3956,0,0,487,6945,129,1067,487,8012,California
Marin,2021-01-10,126,9210,97,5225,29,3985,0,0,51,6921,75,1142,51,8063,California
Marin,2021-01-11,464,9674,325,5550,139,4124,0,0,249,6955,215,1357,249,8312,California
Marin,2021-01-12,937,10611,540,6090,397,4521,0,0,565,7151,369,1726,565,8877,California
Marin,2021-01-13,1174,11785,495,6585,679,5200,0,0,936,7849,238,1964,936,9813,California
Marin,2021-01-14,1065,12850,323,6908,742,5942,0,0,913,8611,151,2115,913,10726,California
Marin,2021-01-15,1143,13993,353,7261,790,6732,0,0,1013,9496,129,2244,1014,11740,California
Marin,2021-01-16,1108,15101,906,8167,202,6934,0,0,1035,10458,73,2317,1035,12775,California
Marin,2021-01-17,1234,16335,1117,9284,117,7051,0,0,1206,11640,27,2344,1209,13984,California
Marin,2021-01-18,359,16694,160,9444,199,7250,0,0,308,11897,51,2395,308,14292,California
Marin,2021-01-19,1143,17837,906,10350,237,7487,0,0,975,12705,167,2562,975,15267,California
Marin,2021-01-20,1772,19609,1204,11554,568,8055,0,0,1048,13040,713,3275,1048,16315,California
Marin,2021-01-21,1680,21289,1063,12617,617,8672,0,0,1329,14024,348,3623,1332,17647,California
Marin,2021-01-22,1685,22974,1077,13694,608,9280,0,0,1520,15379,165,3788,1520,19167,California
Marin,2021-01-23,1849,24823,1347,15041,502,9782,0,0,1765,17060,84,3872,1765,20932,California
Marin,2021-01-24,609,25432,164,15205,445,10227,0,0,577,17605,32,3904,577,21509,California
Marin,2021-01-25,1110,26542,223,15428,887,11114,0,0,684,17864,426,4330,685,22194,California
Marin,2021-01-26,1491,28033,774,16202,717,11831,0,0,1119,18612,371,4701,1119,23313,California
Marin,2021-01-27,1626,29659,861,17063,765,12596,0,0,1332,19653,292,4993,1333,24646,California
Marin,2021-01-28,1991,31650,1041,18104,950,13546,0,0,1776,21215,215,5208,1777,26423,California
Marin,2021-01-29,2174,33824,1432,19536,742,14288,0,0,1983,23019,180,5388,1984,28407,California
Marin,2021-01-30,1710,35534,893,20429,817,15105,0,0,1633,24576,77,5465,1634,30041,California
Marin,2021-01-31,450,35984,314,20743,136,15241,0,0,425,24976,25,5490,425,30466,California
Marin,2021-02-01,1053,37037,414,21157,639,15880,0,0,881,25685,172,5662,881,31347,California
Marin,2021-02-02,1310,38347,454,21611,856,16736,0,0,715,25815,585,6247,715,32062,California
Marin,2021-02-03,1572,39919,414,22025,1158,17894,0,0,1095,26433,477,6724,1095,33157,California
Marin,2021-02-04,1522,41441,506,22531,1016,18910,0,0,932,26777,588,7312,932,34089,California
Marin,2021-02-05,2154,43595,670,23201,1484,20394,0,0,1319,27265,832,8144,1320,35409,California
Marin,2021-02-06,1419,45014,850,24051,569,20963,0,0,596,27039,822,8966,596,36005,California
Marin,2021-02-07,1288,46302,1004,25055,284,21247,0,0,486,26724,801,9767,486,36491,California
Marin,2021-02-08,1498,47800,744,25799,754,22001,0,0,716,26660,780,10547,716,37207,California
Marin,2021-02-09,1761,49561,1113,26912,648,22649,0,0,819,26538,941,11488,819,38026,California
Marin,2021-02-10,2317,51878,1480,28392,837,23486,0,0,1211,26646,1104,12592,1212,39238,California
Marin,2021-02-11,2645,54523,1562,29954,1083,24569,0,0,1345,26697,1296,13888,1347,40585,California
Marin,2021-02-12,3006,57529,1527,31481,1479,26048,0,0,1530,26753,1474,15362,1530,42115,California
Marin,2021-02-13,2324,59853,1232,32713,1092,27140,0,0,1120,26671,1202,16564,1120,43235,California
Marin,2021-02-14,805,60658,299,33012,506,27646,0,0,718,27302,87,16651,718,43953,California
Marin,2021-02-15,1202,61860,348,33360,854,28500,0,0,830,27761,372,17023,831,44784,California
Marin,2021-02-16,2412,64272,1042,34402,1370,29870,0,0,1459,28268,952,17975,1459,46243,California
Marin,2021-02-17,2027,66299,903,35305,1124,30994,0,0,1049,28341,977,18952,1050,47293,California
Marin,2021-02-18,2299,68598,1495,36800,804,31798,0,0,983,28009,1315,20267,983,48276,California
Marin,2021-02-19,2509,71107,2077,38877,432,32230,0,0,1088,27688,1410,21677,1089,49365,California
Marin,2021-02-20,2388,73495,1986,40863,402,32632,0,0,1153,27608,1233,22910,1153,50518,California
Marin,2021-02-21,1196,74691,1015,41878,181,32813,0,0,877,28166,319,23229,877,51395,California
Marin,2021-02-22,1674,76365,1304,43182,370,33183,0,0,1133,28758,541,23770,1133,52528,California
Marin,2021-02-23,2745,79110,1553,44735,1192,34375,0,0,1840,29700,898,24668,1840,54368,California
Marin,2021-02-24,3318,82428,1477,46212,1841,36216,0,0,2114,30618,1196,25864,2114,56482,California
Marin,2021-02-25,3710,86138,1718,47930,1992,38208,0,0,2578,32074,1124,26988,2580,59062,California
Marin,2021-02-26,3307,89445,1831,49761,1476,39684,0,0,2399,33572,901,27889,2399,61461,California
Marin,2021-02-27,2549,91994,1471,51232,1078,40762,0,0,1745,34514,803,28692,1745,63206,California
Marin,2021-02-28,1336,93330,896,52128,440,41202,0,0,1013,35207,320,29012,1013,64219,California
Marin,2021-03-01,2289,95619,1400,53528,889,42091,0,0,1526,35976,757,29769,1526,65745,California
Marin,2021-03-02,2273,97892,1487,55015,786,42877,0,0,1548,36802,723,30492,1549,67294,California
Marin,2021-03-03,3875,101767,2137,57152,1738,44615,0,0,2613,38158,1260,31752,2616,69910,California
Marin,2021-03-04,2767,104534,1351,58503,1416,46031,0,0,2012,39424,750,32502,2016,71926,California
Marin,2021-03-05,2531,107065,809,59312,1710,47741,12,12,1489,39890,1040,33542,1506,73432,California
Marin,2021-03-06,2429,109494,1676,60988,677,48418,76,88,1968,41476,459,34001,2045,75477,California
Marin,2021-03-07,1351,110845,1146,62134,184,48602,21,109,974,42094,377,34378,995,76472,California
Marin,2021-03-08,1351,112196,967,63101,315,48917,69,178,963,42740,387,34765,1033,77505,California
Marin,2021-03-09,2001,114197,1166,64267,728,49645,107,285,1381,43608,620,35385,1488,78993,California
Marin,2021-03-10,3923,118120,2379,66646,1428,51073,116,401,2915,45634,1006,36391,3032,82025,California
Marin,2021-03-11,4229,122349,1715,68361,2383,53456,131,532,3041,47625,1184,37575,3175,85200,California
Marin,2021-03-12,3489,125838,1419,69780,1742,55198,328,860,1368,47205,2115,39690,1695,86895,California
Marin,2021-03-13,3771,129609,2683,72463,1038,56236,50,910,2318,48126,1447,41137,2368,89263,California
Marin,2021-03-14,2095,131704,1057,73520,931,57167,107,1017,703,47547,1391,42528,812,90075,California
Marin,2021-03-15,3201,134905,1756,75276,1396,58563,49,1066,1274,46944,1925,44453,1322,91397,California
Marin,2021-03-16,4144,139049,2273,77549,1586,60149,285,1351,1570,46227,2571,47024,1854,93251,California
Marin,2021-03-17,3209,142258,1944,79493,1232,61381,33,1384,1426,45911,1776,48800,1460,94711,California
Marin,2021-03-18,2139,144397,1173,80666,949,62330,17,1401,1077,45951,1054,49854,1094,95805,California
Marin,2021-03-19,1087,145484,684,81350,391,62721,12,1413,576,46031,508,50362,588,96393,California
Yolo,2020-12-15,39,39,39,39,0,0,0,0,39,39,0,0,39,39,California
Yolo,2020-12-16,78,117,78,117,0,0,0,0,78,117,0,0,78,117,California
Yolo,2020-12-17,101,218,101,218,0,0,0,0,101,218,0,0,101,218,California
Yolo,2020-12-18,207,425,207,425,0,0,0,0,207,425,0,0,207,425,California
Yolo,2020-12-19,85,510,85,510,0,0,0,0,85,510,0,0,85,510,California
Yolo,2020-12-20,100,610,100,610,0,0,0,0,100,610,0,0,100,610,California
Yolo,2020-12-21,252,862,252,862,0,0,0,0,252,862,0,0,252,862,California
Yolo,2020-12-22,386,1248,385,1247,1,1,0,0,386,1248,0,0,386,1248,California
Yolo,2020-12-23,431,1679,413,1660,18,19,0,0,431,1679,0,0,431,1679,California
Yolo,2020-12-24,151,1830,94,1754,57,76,0,0,151,1830,0,0,151,1830,California
Yolo,2020-12-25,1,1831,1,1755,0,76,0,0,1,1831,0,0,1,1831,California
Yolo,2020-12-26,76,1907,25,1780,51,127,0,0,76,1907,0,0,76,1907,California
Yolo,2020-12-27,46,1953,19,1799,27,154,0,0,46,1953,0,0,46,1953,California
Yolo,2020-12-28,343,2296,176,1975,167,321,0,0,343,2296,0,0,343,2296,California
Yolo,2020-12-29,483,2779,268,2243,215,536,0,0,483,2779,0,0,483,2779,California
Yolo,2020-12-30,625,3404,257,2500,368,904,0,0,625,3404,0,0,625,3404,California
Yolo,2020-12-31,183,3587,94,2594,89,993,0,0,183,3587,0,0,183,3587,California
Yolo,2021-01-01,53,3640,53,2647,0,993,0,0,53,3640,0,0,53,3640,California
Yolo,2021-01-02,67,3707,25,2672,42,1035,0,0,67,3707,0,0,67,3707,California
Yolo,2021-01-03,43,3750,19,2691,24,1059,0,0,43,3750,0,0,43,3750,California
Yolo,2021-01-04,195,3945,45,2736,150,1209,0,0,195,3945,0,0,195,3945,California
Yolo,2021-01-05,610,4555,236,2972,374,1583,0,0,550,4435,60,60,550,4495,California
Yolo,2021-01-06,477,5032,181,3153,296,1879,0,0,346,4650,131,191,346,4841,California
Yolo,2021-01-07,705,5737,232,3385,473,2352,0,0,519,4985,185,376,520,5361,California
Yolo,2021-01-08,627,6364,307,3692,320,2672,0,0,412,5183,214,590,412,5773,California
Yolo,2021-01-09,403,6767,67,3759,336,3008,0,0,358,5496,45,635,358,6131,California
Yolo,2021-01-10,390,7157,79,3838,311,3319,0,0,321,5748,69,704,321,6452,California
Yolo,2021-01-11,560,7717,324,4162,236,3555,0,0,291,5770,269,973,291,6743,California
Yolo,2021-01-12,474,8191,357,4519,117,3672,0,0,171,5638,303,1276,171,6914,California
Yolo,2021-01-13,760,8951,308,4827,452,4124,0,0,512,5902,248,1524,512,7426,California
Yolo,2021-01-14,376,9327,183,5010,193,4317,0,0,270,6066,106,1630,270,7696,California
Yolo,2021-01-15,617,9944,318,5328,299,4616,0,0,541,6531,76,1706,541,8237,California
Yolo,2021-01-16,737,10681,95,5423,642,5258,0,0,705,7204,32,1738,705,8942,California
Yolo,2021-01-17,184,10865,116,5539,68,5326,0,0,177,7374,7,1745,177,9119,California
Yolo,2021-01-18,476,11341,304,5843,172,5498,0,0,377,7652,99,1844,377,9496,California
Yolo,2021-01-19,536,11877,369,6212,167,5665,0,0,361,7838,175,2019,361,9857,California
Yolo,2021-01-20,647,12524,377,6589,270,5935,0,0,465,8122,181,2200,465,10322,California
Yolo,2021-01-21,635,13159,379,6968,256,6191,0,0,448,8383,187,2387,448,10770,California
Yolo,2021-01-22,743,13902,250,7218,493,6684,0,0,626,8894,115,2502,626,11396,California
Yolo,2021-01-23,611,14513,121,7339,490,7174,0,0,563,9409,48,2550,563,11959,California
Yolo,2021-01-24,202,14715,121,7460,81,7255,0,0,162,9531,40,2590,162,12121,California
Yolo,2021-01-25,723,15438,151,7611,572,7827,0,0,509,9826,214,2804,509,12630,California
Yolo,2021-01-26,807,16245,324,7935,483,8310,0,0,422,9863,385,3189,422,13052,California
Yolo,2021-01-27,557,16802,222,8157,335,8645,0,0,386,10078,171,3360,386,13438,California
Yolo,2021-01-28,1041,17843,561,8718,480,9125,0,0,918,10874,122,3482,918,14356,California
Yolo,2021-01-29,852,18695,258,8976,594,9719,0,0,770,11563,82,3564,771,15127,California
Yolo,2021-01-30,1515,20210,918,9894,597,10316,0,0,1409,12872,100,3664,1409,16536,California
Yolo,2021-01-31,250,20460,212,10106,38,10354,0,0,216,13054,34,3698,216,16752,California
Yolo,2021-02-01,840,21300,355,10461,485,10839,0,0,612,13441,225,3923,612,17364,California
Yolo,2021-02-02,1317,22617,744,11205,573,11412,0,0,927,13980,390,4313,929,18293,California
Yolo,2021-02-03,1515,24132,392,11597,1123,12535,0,0,1185,14841,327,4640,1188,19481,California
Yolo,2021-02-04,1783,25915,277,11874,1506,14041,0,0,1238,15545,534,5174,1238,20719,California
Yolo,2021-02-05,1512,27427,865,12739,647,14688,0,0,1178,16394,332,5506,1181,21900,California
Yolo,2021-02-06,1923,29350,1249,13988,674,15362,0,0,1564,17600,359,5865,1565,23465,California
Yolo,2021-02-07,513,29863,244,14232,269,15631,0,0,169,17425,344,6209,169,23634,California
Yolo,2021-02-08,949,30812,327,14559,622,16253,0,0,608,17695,338,6547,608,24242,California
Yolo,2021-02-09,847,31659,381,14940,466,16719,0,0,575,17998,272,6819,575,24817,California
Yolo,2021-02-10,1410,33069,468,15408,942,17661,0,0,786,18162,623,7442,787,25604,California
Yolo,2021-02-11,1456,34525,715,16123,741,18402,0,0,1099,18904,357,7799,1099,26703,California
Yolo,2021-02-12,1878,36403,736,16859,1142,19544,0,0,1422,19873,453,8252,1422,28125,California
Yolo,2021-02-13,2040,38443,709,17568,1331,20875,0,0,1379,20591,661,8913,1379,29504,California
Yolo,2021-02-14,559,39002,147,17715,412,21287,0,0,437,20906,122,9035,437,29941,California
Yolo,2021-02-15,521,39523,189,17904,332,21619,0,0,260,20905,261,9296,260,30201,California
Yolo,2021-02-16,1099,40622,415,18319,684,22303,0,0,802,21411,297,9593,803,31004,California
Yolo,2021-02-17,1349,41971,682,19001,667,22970,0,0,972,22007,378,9971,974,31978,California
Yolo,2021-02-18,2400,44371,728,19729,1672,24642,0,0,1652,22911,748,10719,1652,33630,California
Yolo,2021-02-19,1679,46050,723,20452,956,25598,0,0,1086,23412,591,11310,1092,34722,California
Yolo,2021-02-20,2439,48489,939,21391,1500,27098,0,0,1374,23726,1060,12370,1374,36096,California
Yolo,2021-02-21,198,48687,152,21543,46,27144,0,0,61,23651,136,12506,61,36157,California
Yolo,2021-02-22,1336,50023,587,22130,749,27893,0,0,686,23689,649,13155,687,36844,California
Yolo,2021-02-23,1106,51129,832,22962,274,28167,0,0,437,23460,668,13823,439,37283,California
Yolo,2021-02-24,1882,53011,572,23534,1310,29477,0,0,1192,23965,687,14510,1192,38475,California
Yolo,2021-02-25,1287,54298,420,23954,867,30344,0,0,837,24352,450,14960,837,39312,California
Yolo,2021-02-26,2446,56744,945,24899,1501,31845,0,0,1282,24474,1160,16120,1282,40594,California
Yolo,2021-02-27,1585,58329,740,25639,845,32690,0,0,1141,25173,444,16564,1143,41737,California
Yolo,2021-02-28,1730,60059,1480,27119,250,32940,0,0,645,24734,1084,17648,645,42382,California
Yolo,2021-03-01,1013,61072,339,27458,674,33614,0,0,603,24930,408,18056,604,42986,California
Yolo,2021-03-02,1340,62412,641,28099,699,34313,0,0,857,25305,482,18538,857,43843,California
Yolo,2021-03-03,1687,64099,569,28668,1118,35431,0,0,750,25120,935,19473,750,44593,California
Yolo,2021-03-04,2455,66554,1240,29908,1215,36646,0,0,1360,25387,1093,20566,1360,45953,California
Yolo,2021-03-05,1979,68533,1207,31115,761,37407,11,11,1202,25825,777,21343,1215,47168,California
Yolo,2021-03-06,1361,69894,1055,32170,282,37689,24,35,750,25990,609,21952,774,47942,California
Yolo,2021-03-07,855,70749,634,32804,209,37898,12,47,724,26596,131,22083,737,48679,California
Yolo,2021-03-08,907,71656,429,33233,447,38345,31,78,655,27030,252,22335,686,49365,California
Yolo,2021-03-09,1074,72730,581,33814,437,38782,56,134,721,27456,351,22686,777,50142,California
Yolo,2021-03-10,1554,74284,937,34751,354,39136,263,397,655,27474,898,23584,916,51058,California
Yolo,2021-03-11,2064,76348,1360,36111,641,39777,63,460,1405,28287,657,24241,1470,52528,California
Yolo,2021-03-12,2426,78774,1128,37239,1228,41005,70,530,1107,28149,1314,25555,1176,53704,California
Yolo,2021-03-13,1685,80459,652,37891,866,41871,167,697,910,28455,772,26327,1078,54782,California
Yolo,2021-03-14,634,81093,177,38068,315,42186,142,839,380,28724,253,26580,522,55304,California
Yolo,2021-03-15,1250,82343,739,38807,338,42524,173,1012,650,28948,598,27178,822,56126,California
Yolo,2021-03-16,1810,84153,702,39509,1037,43561,71,1083,1060,29332,749,27927,1133,57259,California
Yolo,2021-03-17,2088,86241,845,40354,1204,44765,39,1122,1451,30188,634,28561,1490,58749,California
Yolo,2021-03-18,1169,87410,413,40767,738,45503,18,1140,576,30192,592,29153,596,59345,California
Yolo,2021-03-19,638,88048,254,41021,367,45870,17,1157,335,30246,299,29452,353,59698,California
Yuba,2020-12-16,4,4,4,4,0,0,0,0,4,4,0,0,4,4,California
Yuba,2020-12-17,4,8,4,8,0,0,0,0,4,8,0,0,4,8,California
Yuba,2020-12-18,8,16,8,16,0,0,0,0,8,16,0,0,8,16,California
Yuba,2020-12-19,12,28,12,28,0,0,0,0,12,28,0,0,12,28,California
Yuba,2020-12-20,20,48,20,48,0,0,0,0,20,48,0,0,20,48,California
Yuba,2020-12-21,40,88,40,88,0,0,0,0,40,88,0,0,40,88,California
Yuba,2020-12-22,86,174,86,174,0,0,0,0,86,174,0,0,86,174,California
Yuba,2020-12-23,64,238,62,236,2,2,0,0,64,238,0,0,64,238,California
Yuba,2020-12-24,20,258,10,246,10,12,0,0,20,258,0,0,20,258,California
Yuba,2020-12-26,15,273,13,259,2,14,0,0,15,273,0,0,15,273,California
Yuba,2020-12-27,15,288,15,274,0,14,0,0,15,288,0,0,15,288,California
Yuba,2020-12-28,51,339,35,309,16,30,0,0,51,339,0,0,51,339,California
Yuba,2020-12-29,77,416,10,319,67,97,0,0,77,416,0,0,77,416,California
Yuba,2020-12-30,64,480,21,340,43,140,0,0,64,480,0,0,64,480,California
Yuba,2020-12-31,36,516,6,346,30,170,0,0,36,516,0,0,36,516,California
Yuba,2021-01-02,22,538,21,367,1,171,0,0,22,538,0,0,22,538,California
Yuba,2021-01-03,10,548,6,373,4,175,0,0,10,548,0,0,10,548,California
Yuba,2021-01-04,91,639,21,394,70,245,0,0,91,639,0,0,91,639,California
Yuba,2021-01-05,67,706,36,430,31,276,0,0,66,704,1,1,66,705,California
Yuba,2021-01-06,150,856,74,504,76,352,0,0,144,842,6,7,144,849,California
Yuba,2021-01-07,75,931,20,524,55,407,0,0,72,910,4,11,72,921,California
Yuba,2021-01-08,73,1004,24,548,49,456,0,0,66,969,7,18,66,987,California
Yuba,2021-01-09,19,1023,16,564,3,459,0,0,11,972,8,26,11,998,California
Yuba,2021-01-10,116,1139,22,586,94,553,0,0,94,1044,22,48,94,1092,California
Yuba,2021-01-11,72,1211,49,635,23,576,0,0,32,1036,40,88,32,1124,California
Yuba,2021-01-12,108,1319,78,713,30,606,0,0,43,1014,65,153,43,1167,California
Yuba,2021-01-13,119,1438,72,785,47,653,0,0,54,1004,64,217,54,1221,California
Yuba,2021-01-14,109,1547,43,828,66,719,0,0,97,1089,12,229,97,1318,California
Yuba,2021-01-15,200,1747,85,913,115,834,0,0,189,1267,11,240,189,1507,California
Yuba,2021-01-16,184,1931,21,934,163,997,0,0,172,1426,13,253,172,1679,California
Yuba,2021-01-17,13,1944,9,943,4,1001,0,0,7,1427,6,259,7,1686,California
Yuba,2021-01-18,60,2004,32,975,28,1029,0,0,35,1437,25,284,35,1721,California
Yuba,2021-01-19,79,2083,29,1004,50,1079,0,0,64,1486,15,299,64,1785,California
Yuba,2021-01-20,131,2214,86,1090,45,1124,0,0,108,1571,23,322,108,1893,California
Yuba,2021-01-21,210,2424,95,1185,115,1239,0,0,201,1763,9,331,201,2094,California
Yuba,2021-01-22,102,2526,6,1191,96,1335,0,0,93,1847,9,340,93,2187,California
Yuba,2021-01-23,201,2727,7,1198,194,1529,0,0,198,2042,3,343,198,2385,California
Yuba,2021-01-24,9,2736,7,1205,2,1531,0,0,7,2047,2,345,7,2392,California
Yuba,2021-01-25,82,2818,28,1233,54,1585,0,0,51,2068,30,375,51,2443,California
Yuba,2021-01-26,146,2964,38,1271,108,1693,0,0,91,2104,55,430,91,2534,California
Yuba,2021-01-27,180,3144,128,1399,52,1745,0,0,114,2152,66,496,114,2648,California
Yuba,2021-01-28,209,3353,77,1476,132,1877,0,0,169,2281,40,536,169,2817,California
Yuba,2021-01-29,150,3503,53,1529,97,1974,0,0,104,2339,46,582,104,2921,California
Yuba,2021-01-30,410,3913,23,1552,387,2361,0,0,399,2727,11,593,399,3320,California
Yuba,2021-01-31,17,3930,12,1564,5,2366,0,0,15,2740,2,595,15,3335,California
Yuba,2021-02-01,149,4079,72,1636,77,2443,0,0,129,2850,19,614,129,3464,California
Yuba,2021-02-02,121,4200,22,1658,99,2542,0,0,99,2927,22,636,99,3563,California
Yuba,2021-02-03,225,4425,30,1688,195,2737,0,0,112,2927,112,748,112,3675,California
Yuba,2021-02-04,295,4720,122,1810,173,2910,0,0,253,3138,42,790,253,3928,California
Yuba,2021-02-05,144,4864,29,1839,115,3025,0,0,70,3134,74,864,70,3998,California
Yuba,2021-02-06,447,5311,24,1863,423,3448,0,0,439,3565,8,872,439,4437,California
Yuba,2021-02-07,18,5329,11,1874,7,3455,0,0,15,3577,3,875,15,4452,California
Yuba,2021-02-08,95,5424,35,1909,60,3515,0,0,66,3614,29,904,66,4518,California
Yuba,2021-02-09,149,5573,52,1961,97,3612,0,0,83,3631,66,970,83,4601,California
Yuba,2021-02-10,292,5865,170,2131,122,3734,0,0,110,3559,182,1152,110,4711,California
Yuba,2021-02-11,399,6264,62,2193,337,4071,0,0,303,3768,94,1246,303,5014,California
Yuba,2021-02-12,261,6525,26,2219,235,4306,0,0,149,3805,112,1358,149,5163,California
Yuba,2021-02-13,439,6964,35,2254,404,4710,0,0,391,4148,48,1406,391,5554,California
Yuba,2021-02-14,53,7017,11,2265,42,4752,0,0,48,4191,5,1411,48,5602,California
Yuba,2021-02-15,90,7107,38,2303,52,4804,0,0,70,4241,20,1431,70,5672,California
Yuba,2021-02-16,192,7299,46,2349,146,4950,0,0,134,4317,58,1489,134,5806,California
Yuba,2021-02-17,367,7666,155,2504,212,5162,0,0,95,4140,272,1761,95,5901,California
Yuba,2021-02-18,303,7969,30,2534,273,5435,0,0,180,4197,123,1884,180,6081,California
Yuba,2021-02-19,208,8177,74,2608,134,5569,0,0,127,4244,81,1965,128,6209,California
Yuba,2021-02-20,363,8540,29,2637,334,5903,0,0,311,4503,52,2017,311,6520,California
Yuba,2021-02-21,14,8554,12,2649,2,5905,0,0,6,4501,8,2025,6,6526,California
Yuba,2021-02-22,112,8666,66,2715,46,5951,0,0,35,4460,76,2101,35,6561,California
Yuba,2021-02-23,111,8777,23,2738,88,6039,0,0,44,4438,66,2167,44,6605,California
Yuba,2021-02-24,468,9245,136,2874,332,6371,0,0,100,4170,368,2535,100,6705,California
Yuba,2021-02-25,318,9563,126,3000,192,6563,0,0,195,4242,123,2658,195,6900,California
Yuba,2021-02-26,236,9799,60,3060,176,6739,0,0,129,4266,105,2763,129,7029,California
Yuba,2021-02-27,450,10249,40,3100,410,7149,0,0,369,4554,81,2844,369,7398,California
Yuba,2021-02-28,61,10310,24,3124,37,7186,0,0,40,4573,21,2865,40,7438,California
Yuba,2021-03-01,148,10458,37,3161,111,7297,0,0,73,4573,75,2940,75,7513,California
Yuba,2021-03-02,145,10603,33,3194,112,7409,0,0,74,4576,71,3011,74,7587,California
Yuba,2021-03-03,595,11198,152,3346,443,7852,0,0,191,4364,403,3414,191,7778,California
Yuba,2021-03-04,453,11651,269,3615,184,8036,0,0,318,4547,135,3549,318,8096,California
Yuba,2021-03-05,275,11926,48,3663,226,8262,1,1,219,4711,56,3605,220,8316,California
Yuba,2021-03-06,273,12199,28,3691,239,8501,6,7,172,4788,101,3706,178,8494,California
Yuba,2021-03-07,48,12247,27,3718,21,8522,0,7,32,4804,16,3722,32,8526,California
Yuba,2021-03-08,138,12385,52,3770,72,8594,14,21,83,4846,55,3777,97,8623,California
Yuba,2021-03-09,164,12549,45,3815,100,8694,19,40,75,4851,89,3866,94,8717,California
Yuba,2021-03-10,698,13247,222,4037,461,9155,15,55,215,4599,482,4348,230,8947,California
Yuba,2021-03-11,379,13626,167,4204,202,9357,10,65,252,4734,127,4475,262,9209,California
Yuba,2021-03-12,376,14002,56,4260,273,9630,47,112,104,4614,272,4747,152,9361,California
Yuba,2021-03-13,408,14410,305,4565,90,9720,13,125,335,4889,73,4820,348,9709,California
Yuba,2021-03-14,77,14487,18,4583,49,9769,10,135,41,4904,36,4856,51,9760,California
Yuba,2021-03-15,176,14663,43,4626,115,9884,18,153,87,4920,89,4945,105,9865,California
Yuba,2021-03-16,231,14894,71,4697,138,10022,22,175,140,4992,90,5035,162,10027,California
Yuba,2021-03-17,605,15499,127,4824,453,10475,25,200,138,4689,466,5501,163,10190,California
Yuba,2021-03-18,274,15773,73,4897,158,10633,43,243,172,4803,102,5603,216,10406,California
Yuba,2021-03-19,115,15888,46,4943,49,10682,20,263,68,4844,47,5650,88,10494,California
Mono,2020-12-18,1,1,1,1,0,0,0,0,1,1,0,0,1,1,California
Mono,2020-12-19,5,6,5,6,0,0,0,0,5,6,0,0,5,6,California
Mono,2020-12-20,7,13,7,13,0,0,0,0,7,13,0,0,7,13,California
Mono,2020-12-21,23,36,16,29,7,7,0,0,23,36,0,0,23,36,California
Mono,2020-12-22,67,103,66,95,1,8,0,0,67,103,0,0,67,103,California
Mono,2020-12-23,70,173,42,137,28,36,0,0,70,173,0,0,70,173,California
Mono,2020-12-24,3,176,1,138,2,38,0,0,3,176,0,0,3,176,California
Mono,2020-12-26,3,179,3,141,0,38,0,0,3,179,0,0,3,179,California
Mono,2020-12-28,94,273,63,204,31,69,0,0,94,273,0,0,94,273,California
Mono,2020-12-29,29,302,29,233,0,69,0,0,29,302,0,0,29,302,California
Mono,2020-12-30,76,378,35,268,41,110,0,0,76,378,0,0,76,378,California
Mono,2020-12-31,4,382,1,269,3,113,0,0,4,382,0,0,4,382,California
Mono,2021-01-01,1,383,1,270,0,113,0,0,1,383,0,0,1,383,California
Mono,2021-01-04,1,384,0,270,1,114,0,0,1,384,0,0,1,384,California
Mono,2021-01-05,45,429,2,272,43,157,0,0,44,427,1,1,44,428,California
Mono,2021-01-06,44,473,0,272,44,201,0,0,44,471,0,1,44,472,California
Mono,2021-01-07,56,529,4,276,52,253,0,0,55,525,1,2,55,527,California
Mono,2021-01-08,2,531,1,277,1,254,0,0,1,525,1,3,1,528,California
Mono,2021-01-09,4,535,4,281,0,254,0,0,0,521,4,7,0,528,California
Mono,2021-01-10,5,540,5,286,0,254,0,0,0,516,5,12,0,528,California
Mono,2021-01-11,7,547,4,290,3,257,0,0,4,517,3,15,4,532,California
Mono,2021-01-12,284,831,77,367,207,464,0,0,218,670,65,80,218,750,California
Mono,2021-01-13,235,1066,74,441,161,625,0,0,180,795,55,135,180,930,California
Mono,2021-01-14,74,1140,72,513,2,627,0,0,74,869,0,135,74,1004,California
Mono,2021-01-15,60,1200,2,515,58,685,0,0,60,929,0,135,60,1064,California
Mono,2021-01-16,4,1204,3,518,1,686,0,0,1,927,3,138,1,1065,California
Mono,2021-01-18,63,1267,54,572,9,695,0,0,2,868,61,199,2,1067,California
Mono,2021-01-19,206,1473,204,776,2,697,0,0,169,1000,37,236,169,1236,California
Mono,2021-01-20,233,1706,203,979,30,727,0,0,172,1111,61,297,172,1408,California
Mono,2021-01-21,3,1709,3,982,0,727,0,0,3,1114,0,297,3,1411,California
Mono,2021-01-22,4,1713,0,982,4,731,0,0,4,1118,0,297,4,1415,California
Mono,2021-01-23,598,2311,598,1580,0,731,0,0,598,1716,0,297,598,2013,California
Mono,2021-01-25,204,2515,169,1749,35,766,0,0,168,1848,36,333,168,2181,California
Mono,2021-01-26,510,3025,508,2257,2,768,0,0,506,2350,4,337,506,2687,California
Mono,2021-01-27,5,3030,1,2258,4,772,0,0,5,2355,0,337,5,2692,California
Mono,2021-01-28,6,3036,2,2260,4,776,0,0,2,2353,4,341,2,2694,California
Mono,2021-01-30,201,3237,199,2459,2,778,0,0,201,2554,0,341,201,2895,California
Mono,2021-01-31,242,3479,137,2596,105,883,0,0,138,2590,104,445,140,3035,California
Mono,2021-02-01,29,3508,28,2624,1,884,0,0,0,2562,28,473,0,3035,California
Mono,2021-02-02,5,3513,0,2624,5,889,0,0,2,2561,3,476,2,3037,California
Mono,2021-02-03,4,3517,1,2625,3,892,0,0,2,2561,2,478,2,3039,California
Mono,2021-02-04,213,3730,160,2785,53,945,0,0,91,2530,122,600,91,3130,California
Mono,2021-02-05,623,4353,617,3402,6,951,0,0,620,3147,3,603,620,3750,California
Mono,2021-02-06,140,4493,139,3541,1,952,0,0,139,3285,1,604,139,3889,California
Mono,2021-02-07,2,4495,0,3541,2,954,0,0,2,3287,0,604,2,3891,California
Mono,2021-02-08,172,4667,172,3713,0,954,0,0,17,3149,155,759,17,3908,California
Mono,2021-02-09,227,4894,5,3718,222,1176,0,0,15,2952,212,971,15,3923,California
Mono,2021-02-10,442,5336,187,3905,255,1431,0,0,189,2888,253,1224,189,4112,California
Mono,2021-02-11,7,5343,5,3910,2,1433,0,0,2,2885,5,1229,2,4114,California
Mono,2021-02-12,82,5425,17,3927,65,1498,0,0,24,2851,58,1287,24,4138,California
Mono,2021-02-13,592,6017,592,4519,0,1498,0,0,28,2315,564,1851,28,4166,California
Mono,2021-02-15,171,6188,169,4688,2,1500,0,0,4,2152,167,2018,4,4170,California
Mono,2021-02-16,530,6718,527,5215,3,1503,0,0,48,1719,481,2499,48,4218,California
Mono,2021-02-17,5,6723,2,5217,3,1506,0,0,2,1718,3,2502,2,4220,California
Mono,2021-02-18,1,6724,1,5218,0,1506,0,0,1,1719,0,2502,1,4221,California
Mono,2021-02-19,51,6775,50,5268,1,1507,0,0,51,1770,0,2502,51,4272,California
Mono,2021-02-20,4,6779,4,5272,0,1507,0,0,4,1774,0,2502,4,4276,California
Mono,2021-02-21,3,6782,3,5275,0,1507,0,0,3,1777,0,2502,3,4279,California
Mono,2021-02-22,284,7066,284,5559,0,1507,0,0,23,1540,260,2762,23,4302,California
Mono,2021-02-23,133,7199,114,5673,19,1526,0,0,21,1449,112,2874,21,4323,California
Mono,2021-02-24,6,7205,1,5674,5,1531,0,0,1,1445,5,2879,1,4324,California
Mono,2021-02-25,5,7210,2,5676,3,1534,0,0,3,1447,1,2880,3,4327,California
Mono,2021-02-26,576,7786,576,6252,0,1534,0,0,18,907,558,3438,18,4345,California
Mono,2021-02-27,136,7922,132,6384,4,1538,0,0,3,779,131,3569,3,4348,California
Mono,2021-02-28,1,7923,1,6385,0,1538,0,0,1,780,0,3569,1,4349,California
Mono,2021-03-02,6,7929,4,6389,2,1540,0,0,4,782,2,3571,4,4353,California
Mono,2021-03-03,82,8011,2,6391,80,1620,0,0,79,859,2,3573,79,4432,California
Mono,2021-03-04,7,8018,1,6392,6,1626,0,0,4,860,3,3576,4,4436,California
Mono,2021-03-05,30,8048,25,6417,5,1631,0,0,10,850,20,3596,10,4446,California
Mono,2021-03-06,320,8368,12,6429,308,1939,0,0,318,1166,2,3598,318,4764,California
Mono,2021-03-07,1,8369,0,6429,1,1940,0,0,0,1165,1,3599,0,4764,California
Mono,2021-03-08,453,8822,15,6444,435,2375,3,3,444,1603,9,3608,447,5211,California
Mono,2021-03-09,7,8829,2,6446,4,2379,1,4,5,1607,2,3610,6,5217,California
Mono,2021-03-10,285,9114,93,6539,191,2570,1,5,14,1351,271,3881,15,5232,California
Mono,2021-03-11,13,9127,1,6540,3,2573,9,14,2,1351,11,3892,11,5243,California
Mono,2021-03-12,8,9135,2,6542,2,2575,4,18,0,1347,8,3900,4,5247,California
Mono,2021-03-13,672,9807,316,6858,356,2931,0,18,664,2003,8,3908,664,5911,California
Mono,2021-03-14,4,9811,4,6862,0,2931,0,18,1,2001,3,3911,1,5912,California
Mono,2021-03-15,25,9836,20,6882,2,2933,3,21,12,2003,13,3924,15,5927,California
Mono,2021-03-16,15,9851,6,6888,3,2936,6,27,7,2008,8,3932,13,5940,California
Mono,2021-03-17,13,9864,4,6892,7,2943,2,29,9,2015,4,3936,11,5951,California
Mono,2021-03-18,11,9875,4,6896,5,2948,2,31,5,2017,5,3941,7,5958,California
Mono,2021-03-19,1,9876,0,6896,1,2949,0,31,1,2018,0,3941,1,5959,California
Placer,2020-12-15,29,29,29,29,0,0,0,0,29,29,0,0,29,29,California
Placer,2020-12-16,52,81,52,81,0,0,0,0,52,81,0,0,52,81,California
Placer,2020-12-17,140,221,140,221,0,0,0,0,140,221,0,0,140,221,California
Placer,2020-12-18,331,552,331,552,0,0,0,0,331,552,0,0,331,552,California
Placer,2020-12-19,248,800,248,800,0,0,0,0,248,800,0,0,248,800,California
Placer,2020-12-20,232,1032,232,1032,0,0,0,0,232,1032,0,0,232,1032,California
Placer,2020-12-21,495,1527,494,1526,1,1,0,0,495,1527,0,0,495,1527,California
Placer,2020-12-22,675,2202,669,2195,6,7,0,0,675,2202,0,0,675,2202,California
Placer,2020-12-23,740,2942,655,2850,85,92,0,0,740,2942,0,0,740,2942,California
Placer,2020-12-24,396,3338,345,3195,51,143,0,0,396,3338,0,0,396,3338,California
Placer,2020-12-26,159,3497,114,3309,45,188,0,0,159,3497,0,0,159,3497,California
Placer,2020-12-27,187,3684,163,3472,24,212,0,0,187,3684,0,0,187,3684,California
Placer,2020-12-28,665,4349,539,4011,126,338,0,0,665,4349,0,0,665,4349,California
Placer,2020-12-29,762,5111,514,4525,248,586,0,0,762,5111,0,0,762,5111,California
Placer,2020-12-30,726,5837,449,4974,277,863,0,0,724,5835,0,0,724,5835,California
Placer,2020-12-31,530,6367,344,5318,186,1049,0,0,530,6365,0,0,530,6365,California
Placer,2021-01-01,14,6381,10,5328,4,1053,0,0,14,6379,0,0,14,6379,California
Placer,2021-01-02,184,6565,152,5480,32,1085,0,0,184,6563,0,0,184,6563,California
Placer,2021-01-03,153,6718,78,5558,75,1160,0,0,153,6716,0,0,153,6716,California
Placer,2021-01-04,615,7333,176,5734,439,1599,0,0,615,7331,0,0,615,7331,California
Placer,2021-01-05,710,8043,156,5890,554,2153,0,0,628,7878,81,81,628,7959,California
Placer,2021-01-06,753,8796,241,6131,512,2665,0,0,613,8351,140,221,613,8572,California
Placer,2021-01-07,975,9771,361,6492,614,3279,0,0,774,8925,201,422,775,9347,California
Placer,2021-01-08,1179,10950,525,7017,654,3933,0,0,852,9453,324,746,852,10199,California
Placer,2021-01-09,443,11393,316,7333,127,4060,0,0,228,9467,214,960,228,10427,California
Placer,2021-01-10,326,11719,184,7517,142,4202,0,0,162,9465,164,1124,162,10589,California
Placer,2021-01-11,1423,13142,807,8324,616,4818,0,0,834,9711,589,1713,835,11424,California
Placer,2021-01-12,1629,14771,864,9188,765,5583,0,0,1027,10137,602,2315,1028,12452,California
Placer,2021-01-13,1618,16389,816,10004,802,6385,0,0,1202,10929,413,2728,1205,13657,California
Placer,2021-01-14,1730,18119,649,10653,1081,7466,0,0,1374,11951,353,3081,1375,15032,California
Placer,2021-01-15,1898,20017,715,11368,1183,8649,0,0,1545,13148,352,3433,1549,16581,California
Placer,2021-01-16,1468,21485,721,12089,747,9396,0,0,1346,14373,122,3555,1347,17928,California
Placer,2021-01-17,557,22042,394,12483,163,9559,0,0,425,14666,132,3687,425,18353,California
Placer,2021-01-18,975,23017,538,13021,437,9996,0,0,746,15184,229,3916,747,19100,California
Placer,2021-01-19,2548,25565,1945,14966,603,10599,0,0,2101,16838,447,4363,2101,21201,California
Placer,2021-01-20,2229,27794,1686,16652,543,11142,0,0,1901,18412,328,4691,1902,23103,California
Placer,2021-01-21,2516,30310,1109,17761,1407,12549,0,0,2120,20138,395,5086,2121,25224,California
Placer,2021-01-22,2265,32575,588,18349,1677,14226,0,0,2089,22056,174,5260,2092,27316,California
Placer,2021-01-23,1186,33761,377,18726,809,15035,0,0,1030,22931,156,5416,1031,28347,California
Placer,2021-01-24,503,34264,266,18992,237,15272,0,0,428,23285,75,5491,429,28776,California
Placer,2021-01-25,1633,35897,789,19781,844,16116,0,0,1352,24357,281,5772,1353,30129,California
Placer,2021-01-26,1823,37720,1025,20806,798,16914,0,0,1562,25658,261,6033,1562,31691,California
Placer,2021-01-27,1809,39529,1154,21960,655,17569,0,0,1569,26989,238,6271,1569,33260,California
Placer,2021-01-28,1763,41292,1100,23060,663,18232,0,0,1522,28270,241,6512,1522,34782,California
Placer,2021-01-29,1824,43116,1150,24210,674,18906,0,0,1639,29727,184,6696,1641,36423,California
Placer,2021-01-30,1711,44827,961,25171,750,19656,0,0,1594,31206,116,6812,1595,38018,California
Placer,2021-01-31,780,45607,621,25792,159,19815,0,0,708,31844,71,6883,709,38727,California
Placer,2021-02-01,2047,47654,1082,26874,965,20780,0,0,1742,33283,303,7186,1742,40469,California
Placer,2021-02-02,2344,49998,1530,28404,814,21594,0,0,1874,34689,468,7654,1874,42343,California
Placer,2021-02-03,2885,52883,1860,30264,1025,22619,0,0,2278,36364,603,8257,2278,44621,California
Placer,2021-02-04,2734,55617,1169,31433,1565,24184,0,0,1919,37471,813,9070,1920,46541,California
Placer,2021-02-05,2693,58310,1190,32623,1503,25687,0,0,1379,37542,1308,10378,1379,47920,California
Placer,2021-02-06,1895,60205,1267,33890,628,26315,0,0,1353,38353,542,10920,1353,49273,California
Placer,2021-02-07,1207,61412,901,34791,306,26621,0,0,932,39012,274,11194,933,50206,California
Placer,2021-02-08,3262,64674,1745,36536,1517,28138,0,0,1961,39682,1293,12487,1963,52169,California
Placer,2021-02-09,3503,68177,2150,38686,1353,29491,0,0,1618,39415,1885,14372,1618,53787,California
Placer,2021-02-10,3701,71878,2174,40860,1527,31018,0,0,1734,39187,1964,16336,1736,55523,California
Placer,2021-02-11,3498,75376,1809,42669,1689,32707,0,0,1493,38682,1999,18335,1494,57017,California
Placer,2021-02-12,2709,78085,1303,43972,1406,34113,0,0,1642,39272,1052,19387,1642,58659,California
Placer,2021-02-13,2506,80591,1487,45459,1019,35132,0,0,1860,40486,646,20033,1860,60519,California
Placer,2021-02-14,1061,81652,672,46131,389,35521,0,0,726,40880,332,20365,726,61245,California
Placer,2021-02-15,2111,83763,1010,47141,1101,36622,0,0,1470,41710,641,21006,1471,62716,California
Placer,2021-02-16,3479,87242,1771,48912,1708,38330,0,0,1558,41355,1915,22921,1560,64276,California
Placer,2021-02-17,3362,90604,1910,50822,1452,39782,0,0,1411,40818,1948,24869,1411,65687,California
Placer,2021-02-18,3420,94024,1802,52624,1618,41400,0,0,1358,40122,2054,26923,1358,67045,California
Placer,2021-02-19,3310,97334,1742,54366,1568,42968,0,0,1193,39214,2114,29037,1206,68251,California
Placer,2021-02-20,1899,99233,1179,55545,720,43688,0,0,826,38971,1070,30107,827,69078,California
Placer,2021-02-21,855,100088,643,56188,212,43900,0,0,242,38602,612,30719,243,69321,California
Placer,2021-02-22,2405,102493,1700,57888,705,44605,0,0,551,37300,1853,32572,551,69872,California
Placer,2021-02-23,2411,104904,1497,59385,914,45519,0,0,846,36587,1561,34133,848,70720,California
Placer,2021-02-24,3114,108018,1123,60508,1991,47510,0,0,1705,36893,1401,35534,1707,72427,California
Placer,2021-02-25,3164,111182,1306,61814,1858,49368,0,0,1602,36949,1557,37091,1613,74040,California
Placer,2021-02-26,3833,115015,2298,64112,1535,50903,0,0,2177,37478,1650,38741,2179,76219,California
Placer,2021-02-27,2685,117700,1399,65511,1286,52189,0,0,1384,37567,1296,40037,1385,77604,California
Placer,2021-02-28,1349,119049,780,66291,569,52758,0,0,548,37320,795,40832,548,78152,California
Placer,2021-03-01,2855,121904,1926,68217,929,53687,0,0,1446,37365,1404,42236,1449,79601,California
Placer,2021-03-02,2722,124626,1714,69931,1008,54695,0,0,1807,38265,909,43145,1809,81410,California
Placer,2021-03-03,2850,127476,1275,71206,1575,56270,0,0,1498,38416,1347,44492,1498,82908,California
Placer,2021-03-04,3103,130579,1169,72375,1934,58204,0,0,1610,38548,1482,45974,1614,84522,California
Placer,2021-03-05,2510,133089,784,73159,1705,59909,21,21,1475,39016,1030,47004,1498,86020,California
Placer,2021-03-06,2187,135276,1362,74521,754,60663,71,92,780,38467,1403,48407,854,86874,California
Placer,2021-03-07,1247,136523,737,75258,476,61139,34,126,503,38262,742,49149,537,87411,California
Placer,2021-03-08,2577,139100,1697,76955,792,61931,88,214,1452,38677,1125,50274,1540,88951,California
Placer,2021-03-09,2884,141984,1535,78490,1262,63193,87,301,1668,39219,1214,51488,1756,90707,California
Placer,2021-03-10,2953,144937,1188,79678,1685,64878,80,381,1490,39330,1458,52946,1569,92276,California
Placer,2021-03-11,3258,148195,1451,81129,1693,66571,114,495,1641,39476,1612,54558,1758,94034,California
Placer,2021-03-12,3217,151412,1367,82496,1146,67717,704,1199,1169,39306,2045,56603,1875,95909,California
Placer,2021-03-13,1853,153265,684,83180,1060,68777,109,1308,1051,39671,798,57401,1163,97072,California
Placer,2021-03-14,1439,154704,639,83819,671,69448,129,1437,857,40077,581,57982,987,98059,California
Placer,2021-03-15,2858,157562,1348,85167,1382,70830,128,1565,1543,40443,1306,59288,1672,99731,California
Placer,2021-03-16,3332,160894,1761,86928,1437,72267,134,1699,2148,41549,1176,60464,2282,102013,California
Placer,2021-03-17,2534,163428,1254,88182,1197,73464,83,1782,1626,42351,908,61372,1710,103723,California
Placer,2021-03-18,1813,165241,1050,89232,747,74211,16,1798,1315,43187,496,61868,1332,105055,California
Placer,2021-03-19,900,166141,442,89674,394,74605,64,1862,573,43500,325,62193,638,105693,California
Alameda,2020-12-15,35,35,35,35,0,0,0,0,35,35,0,0,35,35,California
Alameda,2020-12-16,201,236,201,236,0,0,0,0,201,236,0,0,201,236,California
Alameda,2020-12-17,441,677,441,677,0,0,0,0,441,677,0,0,441,677,California
Alameda,2020-12-18,1785,2462,1784,2461,1,1,0,0,1785,2462,0,0,1785,2462,California
Alameda,2020-12-19,1462,3924,1462,3923,0,1,0,0,1463,3925,0,0,1463,3925,California
Alameda,2020-12-20,1178,5102,1177,5100,1,2,0,0,1177,5101,1,1,1177,5102,California
Alameda,2020-12-21,1845,6947,1844,6944,1,3,0,0,1844,6945,0,1,1844,6946,California
Alameda,2020-12-22,2084,9031,2033,8977,51,54,0,0,2084,9029,0,1,2084,9030,California
Alameda,2020-12-23,1887,10918,1633,10610,254,308,0,0,1887,10916,0,1,1887,10917,California
Alameda,2020-12-24,1214,12132,759,11369,455,763,0,0,1214,12130,0,1,1214,12131,California
Alameda,2020-12-25,160,12292,124,11493,36,799,0,0,160,12290,0,1,160,12291,California
Alameda,2020-12-26,852,13144,311,11804,541,1340,0,0,852,13142,0,1,852,13143,California
Alameda,2020-12-27,498,13642,255,12059,243,1583,0,0,498,13640,0,1,498,13641,California
Alameda,2020-12-28,1856,15498,928,12987,928,2511,0,0,1856,15496,0,1,1856,15497,California
Alameda,2020-12-29,2417,17915,1020,14007,1397,3908,0,0,2416,17912,0,1,2416,17913,California
Alameda,2020-12-30,3098,21013,1337,15344,1761,5669,0,0,3098,21010,0,1,3098,21011,California
Alameda,2020-12-31,1777,22790,435,15779,1342,7011,0,0,1777,22787,0,1,1777,22788,California
Alameda,2021-01-01,167,22957,68,15847,99,7110,0,0,167,22954,0,1,167,22955,California
Alameda,2021-01-02,705,23662,514,16361,191,7301,0,0,705,23659,0,1,705,23660,California
Alameda,2021-01-03,336,23998,215,16576,121,7422,0,0,333,23989,3,4,333,23993,California
Alameda,2021-01-04,1639,25637,938,17514,701,8123,0,0,1627,25605,11,15,1627,25620,California
Alameda,2021-01-05,2189,27826,1255,18769,934,9057,0,0,1953,27324,234,249,1953,27573,California
Alameda,2021-01-06,3238,31064,1776,20545,1462,10519,0,0,2414,28918,822,1071,2416,29989,California
Alameda,2021-01-07,3731,34795,2097,22642,1634,12153,0,0,2615,30436,1107,2178,2625,32614,California
Alameda,2021-01-08,4723,39518,2700,25342,2023,14176,0,0,3094,31909,1624,3802,3097,35711,California
Alameda,2021-01-09,2026,41544,1385,26727,641,14817,0,0,1170,32223,856,4658,1170,36881,California
Alameda,2021-01-10,1032,42576,814,27541,218,15035,0,0,422,32034,611,5269,422,37303,California
Alameda,2021-01-11,4454,47030,3329,30870,1125,16160,0,0,2772,33130,1682,6951,2778,40081,California
Alameda,2021-01-12,4745,51775,3186,34056,1559,17719,0,0,3385,35155,1360,8311,3385,43466,California
Alameda,2021-01-13,4998,56773,2637,36693,2361,20080,0,0,3833,37830,1161,9472,3836,47302,California
Alameda,2021-01-14,5569,62342,2721,39414,2848,22928,0,0,4695,41664,865,10337,4699,52001,California
Alameda,2021-01-15,5794,68136,2404,41818,3390,26318,0,0,4982,45843,805,11142,4984,56985,California
Alameda,2021-01-16,3111,71247,1474,43292,1637,27955,0,0,2807,48346,304,11446,2807,59792,California
Alameda,2021-01-17,1866,73113,1072,44364,794,28749,0,0,1663,49806,203,11649,1663,61455,California
Alameda,2021-01-18,3226,76339,2083,46447,1143,29892,0,0,2609,51808,613,12262,2615,64070,California
Alameda,2021-01-19,5484,81823,3320,49767,2164,32056,0,0,4298,54926,1184,13446,4302,68372,California
Alameda,2021-01-20,6574,88397,4019,53786,2555,34611,0,0,5284,58936,1278,14724,5288,73660,California
Alameda,2021-01-21,7622,96019,3363,57149,4259,38870,0,0,6817,64956,799,15523,6819,80479,California
Alameda,2021-01-22,6907,102926,2046,59195,4861,43731,0,0,5750,69558,1150,16673,5752,86231,California
Alameda,2021-01-23,3262,106188,933,60128,2329,46060,0,0,2715,71727,546,17219,2715,88946,California
Alameda,2021-01-24,2084,108272,676,60804,1408,47468,0,0,1792,73232,288,17507,1793,90739,California
Alameda,2021-01-25,5149,113421,1959,62763,3190,50658,0,0,3602,75295,1541,19048,3604,94343,California
Alameda,2021-01-26,7189,120610,2260,65023,4929,55587,0,0,5331,78778,1848,20896,5331,99674,California
Alameda,2021-01-27,6632,127242,2050,67073,4582,60169,0,0,4820,81796,1802,22698,4820,104494,California
Alameda,2021-01-28,7726,134968,2430,69503,5296,65465,0,0,5562,85212,2147,24845,5563,110057,California
Alameda,2021-01-29,7762,142730,3080,72583,4682,70147,0,0,6008,89477,1743,26588,6008,116065,California
Alameda,2021-01-30,3236,145966,1498,74081,1738,71885,0,0,2699,91643,534,27122,2700,118765,California
Alameda,2021-01-31,2137,148103,1190,75271,947,72832,0,0,1664,92851,457,27579,1665,120430,California
Alameda,2021-02-01,5886,153989,3315,78586,2571,75403,0,0,4281,95534,1599,29178,4282,124712,California
Alameda,2021-02-02,7365,161354,4212,82798,3153,78556,0,0,4595,97369,2761,31939,4596,129308,California
Alameda,2021-02-03,7025,168379,3720,86518,3305,81861,0,0,4368,99087,2653,34592,4371,133679,California
Alameda,2021-02-04,9420,177799,4104,90622,5316,87177,0,0,6416,102519,2988,37580,6420,140099,California
Alameda,2021-02-05,10262,188061,5379,96001,4883,92060,0,0,6418,105106,3835,41415,6422,146521,California
Alameda,2021-02-06,6850,194911,4386,100387,2464,94524,0,0,5749,109753,1103,42518,5750,152271,California
Alameda,2021-02-07,3549,198460,2865,103252,684,95208,0,0,2633,111472,915,43433,2634,154905,California
Alameda,2021-02-08,7929,206389,5689,108941,2240,97448,0,0,5452,114459,2466,45899,5453,160358,California
Alameda,2021-02-09,9601,215990,5809,114750,3792,101240,0,0,6000,116864,3596,49495,6001,166359,California
Alameda,2021-02-10,11373,227363,6732,121482,4641,105881,0,0,6604,118722,4753,54248,6611,172970,California
Alameda,2021-02-11,12714,240077,6919,128401,5795,111676,0,0,8172,122369,4532,58780,8179,181149,California
Alameda,2021-02-12,12224,252301,5601,134002,6623,118299,0,0,7566,125288,4649,63429,7568,188717,California
Alameda,2021-02-13,7684,259985,3995,137997,3689,121988,0,0,5773,129151,1910,65339,5773,194490,California
Alameda,2021-02-14,4012,263997,2536,140533,1476,123464,0,0,2857,130856,1153,66492,2858,197348,California
Alameda,2021-02-15,5644,269641,3195,143728,2449,125913,0,0,3658,132532,1984,68476,3660,201008,California
Alameda,2021-02-16,12122,281763,6751,150479,5371,131284,0,0,9031,138486,3084,71560,9038,210046,California
Alameda,2021-02-17,13541,295304,8052,158531,5489,136773,0,0,10107,145177,3423,74983,10114,220160,California
Alameda,2021-02-18,14795,310099,9416,167947,5379,142152,0,0,10837,152060,3957,78940,10840,231000,California
Alameda,2021-02-19,16364,326463,10759,178706,5605,147757,0,0,11047,157827,5305,84245,11072,242072,California
Alameda,2021-02-20,11465,337928,9359,188065,2106,149863,0,0,8912,164195,2552,86797,8920,250992,California
Alameda,2021-02-21,5882,343810,5009,193074,873,150736,0,0,3543,165414,2333,89130,3552,254544,California
Alameda,2021-02-22,10255,354065,7605,200679,2650,153386,0,0,6566,168314,3676,92806,6576,261120,California
Alameda,2021-02-23,12302,366367,7488,208167,4814,158200,0,0,7708,171448,4588,97394,7722,268842,California
Alameda,2021-02-24,13914,380281,7698,215865,6216,164416,0,0,9048,175654,4854,102248,9060,277902,California
Alameda,2021-02-25,14851,395132,8792,224657,6059,170475,0,0,9406,179656,5417,107665,9419,287321,California
Alameda,2021-02-26,16845,411977,9797,234454,7048,177523,0,0,11009,184875,5805,113470,11024,298345,California
Alameda,2021-02-27,14450,426427,10618,245072,3832,181355,0,0,8978,188408,5454,118924,8987,307332,California
Alameda,2021-02-28,8956,435383,7603,252675,1353,182708,0,0,5961,191385,2988,121912,5965,313297,California
Alameda,2021-03-01,12731,448114,8901,261576,3830,186538,0,0,7966,194637,4730,126642,7982,321279,California
Alameda,2021-03-02,12782,460896,8929,270505,3853,190391,0,0,8404,198679,4365,131007,8407,329686,California
Alameda,2021-03-03,13717,474613,8998,279503,4719,195110,0,0,9292,203570,4408,135415,9299,338985,California
Alameda,2021-03-04,15063,489676,9543,289046,5520,200630,0,0,9419,207394,5619,141034,9443,348428,California
Alameda,2021-03-05,13817,503493,8714,297760,5099,205729,4,4,9377,212373,4419,145453,9398,357826,California
Alameda,2021-03-06,13162,516655,9577,307337,3334,209063,251,255,8806,217104,4340,149793,9071,366897,California
Alameda,2021-03-07,9218,525873,8014,315351,1128,210191,76,331,6547,221065,2664,152457,6625,373522,California
Alameda,2021-03-08,10780,536653,6812,322163,3749,213940,219,550,8261,227043,2510,154967,8488,382010,California
Alameda,2021-03-09,10878,547531,6638,328801,3815,217755,425,975,6261,229127,4607,159574,6691,388701,California
Alameda,2021-03-10,15785,563316,10898,339699,4362,222117,525,1500,7187,228261,8582,168156,7716,396417,California
Alameda,2021-03-11,18835,582151,10964,350663,6449,228566,1422,2922,6961,224800,11853,180009,8392,404809,California
Alameda,2021-03-12,18519,600670,11073,361736,6282,234848,1164,4086,6995,221469,11507,191516,8176,412985,California
Alameda,2021-03-13,13419,614089,8755,370491,3878,238726,786,4872,4592,218049,8801,200317,5381,418366,California
Alameda,2021-03-14,10091,624180,7601,378092,1745,240471,745,5617,4637,217984,5447,205764,5382,423748,California
Alameda,2021-03-15,14007,638187,9264,387356,4270,244741,473,6090,6375,217223,7609,213373,6848,430596,California
Alameda,2021-03-16,17140,655327,11072,398428,5536,250277,532,6622,7871,216410,9219,222592,8406,439002,California
Alameda,2021-03-17,15405,670732,9032,407460,5791,256068,582,7204,7142,215896,8243,230835,7729,446731,California
Alameda,2021-03-18,11304,682036,6779,414239,3905,259973,620,7824,4886,215008,6404,237239,5516,452247,California
Alameda,2021-03-19,7817,689853,4664,418903,2207,262180,946,8770,2817,213786,4994,242233,3772,456019,California
Kings,2020-12-16,1,1,1,1,0,0,0,0,1,1,0,0,1,1,California
Kings,2020-12-17,8,9,8,9,0,0,0,0,8,9,0,0,8,9,California
Kings,2020-12-18,12,21,12,21,0,0,0,0,12,21,0,0,12,21,California
Kings,2020-12-19,11,32,11,32,0,0,0,0,11,32,0,0,11,32,California
Kings,2020-12-20,13,45,13,45,0,0,0,0,13,45,0,0,13,45,California
Kings,2020-12-21,153,198,153,198,0,0,0,0,270,315,0,0,270,315,California
Kings,2020-12-22,142,340,142,340,0,0,0,0,139,454,0,0,139,454,California
Kings,2020-12-23,134,474,122,462,12,12,0,0,135,589,0,0,135,589,California
Kings,2020-12-24,11,485,9,471,2,14,0,0,11,600,0,0,11,600,California
Kings,2020-12-26,7,492,4,475,3,17,0,0,7,607,0,0,7,607,California
Kings,2020-12-27,4,496,4,479,0,17,0,0,4,611,0,0,4,611,California
Kings,2020-12-28,130,626,103,582,27,44,0,0,131,742,0,0,131,742,California
Kings,2020-12-29,78,704,51,633,27,71,0,0,79,821,0,0,79,821,California
Kings,2020-12-30,147,851,108,741,39,110,0,0,147,968,0,0,147,968,California
Kings,2020-12-31,44,895,6,747,38,148,0,0,44,1012,0,0,44,1012,California
Kings,2021-01-01,1,896,0,747,1,149,0,0,1,1013,0,0,1,1013,California
Kings,2021-01-02,10,906,9,756,1,150,0,0,10,1023,0,0,10,1023,California
Kings,2021-01-04,112,1018,41,797,71,221,0,0,112,1135,0,0,112,1135,California
Kings,2021-01-05,197,1215,39,836,158,379,0,0,197,1332,0,0,197,1332,California
Kings,2021-01-06,275,1490,178,1014,97,476,0,0,272,1601,3,3,272,1604,California
Kings,2021-01-07,179,1669,82,1096,97,573,0,0,171,1764,8,11,171,1775,California
Kings,2021-01-08,246,1915,53,1149,193,766,0,0,228,1974,18,29,228,2003,California
Kings,2021-01-09,63,1978,9,1158,54,820,0,0,55,2021,8,37,55,2058,California
Kings,2021-01-10,15,1993,3,1161,12,832,0,0,12,2030,3,40,12,2070,California
Kings,2021-01-11,516,2509,354,1515,162,994,0,0,273,2061,243,283,274,2344,California
Kings,2021-01-12,352,2861,255,1770,97,1091,0,0,218,2148,131,414,218,2562,California
Kings,2021-01-13,413,3274,266,2036,147,1238,0,0,322,2379,91,505,322,2884,California
Kings,2021-01-14,206,3480,31,2067,175,1413,0,0,196,2555,21,526,197,3081,California
Kings,2021-01-15,413,3893,28,2095,385,1798,0,0,401,2944,12,538,401,3482,California
Kings,2021-01-16,31,3924,12,2107,19,1817,0,0,30,2973,1,539,30,3512,California
Kings,2021-01-17,8,3932,5,2112,3,1820,0,0,6,2977,2,541,6,3518,California
Kings,2021-01-18,172,4104,40,2152,132,1952,0,0,146,3097,26,567,146,3664,California
Kings,2021-01-19,376,4480,158,2310,218,2170,0,0,248,3217,128,695,248,3912,California
Kings,2021-01-20,223,4703,134,2444,89,2259,0,0,122,3238,101,796,122,4034,California
Kings,2021-01-21,185,4888,32,2476,153,2412,0,0,171,3393,16,812,171,4205,California
Kings,2021-01-22,123,5011,37,2513,86,2498,0,0,123,3512,4,816,123,4328,California
Kings,2021-01-23,26,5037,14,2527,12,2510,0,0,20,3526,6,822,20,4348,California
Kings,2021-01-24,2,5039,2,2529,0,2510,0,0,0,3524,2,824,0,4348,California
Kings,2021-01-25,123,5162,25,2554,98,2608,0,0,90,3581,33,857,90,4438,California
Kings,2021-01-26,153,5315,34,2588,119,2727,0,0,114,3656,39,896,114,4552,California
Kings,2021-01-27,316,5631,34,2622,282,3009,0,0,246,3833,69,965,246,4798,California
Kings,2021-01-28,323,5954,47,2669,276,3285,0,0,268,4046,55,1020,268,5066,California
Kings,2021-01-29,85,6039,26,2695,59,3344,0,0,68,4097,17,1037,68,5134,California
Kings,2021-01-30,1424,7463,31,2726,1393,4737,0,0,1423,5519,1,1038,1423,6557,California
Kings,2021-02-01,198,7661,64,2790,134,4871,0,0,71,5465,125,1163,71,6628,California
Kings,2021-02-02,223,7884,13,2803,210,5081,0,0,80,5403,142,1305,80,6708,California
Kings,2021-02-03,349,8233,190,2993,159,5240,0,0,195,5445,153,1458,195,6903,California
Kings,2021-02-04,390,8623,97,3090,293,5533,0,0,196,5447,194,1652,196,7099,California
Kings,2021-02-05,253,8876,13,3103,240,5773,0,0,100,5395,152,1804,100,7199,California
Kings,2021-02-06,58,8934,10,3113,48,5821,0,0,26,5389,32,1836,26,7225,California
Kings,2021-02-07,5,8939,3,3116,2,5823,0,0,3,5390,2,1838,3,7228,California
Kings,2021-02-08,168,9107,26,3142,142,5965,0,0,67,5356,101,1939,67,7295,California
Kings,2021-02-09,251,9358,56,3198,195,6160,0,0,108,5323,141,2080,108,7403,California
Kings,2021-02-10,285,9643,111,3309,174,6334,0,0,175,5388,110,2190,175,7578,California
Kings,2021-02-11,412,10055,64,3373,348,6682,0,0,305,5587,107,2297,306,7884,California
Kings,2021-02-12,602,10657,36,3409,566,7248,0,0,344,5673,258,2555,344,8228,California
Kings,2021-02-13,100,10757,6,3415,94,7342,0,0,75,5723,25,2580,75,8303,California
Kings,2021-02-14,99,10856,4,3419,95,7437,0,0,94,5812,5,2585,94,8397,California
Kings,2021-02-15,228,11084,4,3423,224,7661,0,0,120,5825,107,2692,120,8517,California
Kings,2021-02-16,473,11557,31,3454,442,8103,0,0,241,5835,231,2923,241,8758,California
Kings,2021-02-17,362,11919,21,3475,341,8444,0,0,227,5927,135,3058,227,8985,California
Kings,2021-02-18,143,12062,21,3496,122,8566,0,0,90,5965,53,3111,91,9076,California
Kings,2021-02-19,155,12217,22,3518,133,8699,0,0,102,6019,52,3163,106,9182,California
Kings,2021-02-20,155,12372,40,3558,115,8814,0,0,126,6116,29,3192,126,9308,California
Kings,2021-02-21,1,12373,0,3558,1,8815,0,0,1,6117,0,3192,1,9309,California
Kings,2021-02-22,102,12475,19,3577,83,8898,0,0,42,6099,60,3252,42,9351,California
Kings,2021-02-23,277,12752,68,3645,209,9107,0,0,162,6146,115,3367,162,9513,California
Kings,2021-02-24,571,13323,145,3790,426,9533,0,0,369,6314,202,3569,370,9883,California
Kings,2021-02-25,642,13965,108,3898,534,10067,0,0,430,6534,210,3779,430,10313,California
Kings,2021-02-26,608,14573,126,4024,482,10549,0,0,553,7034,53,3832,553,10866,California
Kings,2021-02-27,1238,15811,60,4084,1178,11727,0,0,599,6997,639,4471,602,11468,California
Kings,2021-02-28,999,16810,443,4527,556,12283,0,0,512,7023,486,4957,512,11980,California
Kings,2021-03-01,245,17055,74,4601,171,12454,0,0,202,7184,43,5000,204,12184,California
Kings,2021-03-02,429,17484,195,4796,234,12688,0,0,387,7529,42,5042,387,12571,California
Kings,2021-03-03,544,18028,274,5070,270,12958,0,0,383,7752,160,5202,383,12954,California
Kings,2021-03-04,556,18584,271,5341,285,13243,0,0,469,8134,87,5289,469,13423,California
Kings,2021-03-05,861,19445,311,5652,541,13784,9,9,748,8779,113,5402,758,14181,California
Kings,2021-03-06,500,19945,185,5837,302,14086,13,22,470,9233,30,5432,484,14665,California
Kings,2021-03-07,219,20164,83,5920,132,14218,4,26,211,9440,8,5440,215,14880,California
Kings,2021-03-08,273,20437,69,5989,158,14376,46,72,178,9569,95,5535,224,15104,California
Kings,2021-03-09,377,20814,121,6110,211,14587,45,117,289,9815,88,5623,334,15438,California
Kings,2021-03-10,375,21189,91,6201,240,14827,44,161,265,10015,108,5731,308,15746,California
Kings,2021-03-11,792,21981,252,6453,434,15261,106,267,533,10399,256,5987,640,16386,California
Kings,2021-03-12,962,22943,228,6681,649,15910,85,352,673,10869,288,6275,758,17144,California
Kings,2021-03-13,347,23290,81,6762,227,16137,39,391,268,11098,79,6354,308,17452,California
Kings,2021-03-14,143,23433,77,6839,47,16184,19,410,80,11134,63,6417,99,17551,California
Kings,2021-03-15,563,23996,159,6998,290,16474,114,524,341,11367,222,6639,455,18006,California
Kings,2021-03-16,918,24914,324,7322,531,17005,63,587,594,11701,321,6960,655,18661,California
Kings,2021-03-17,830,25744,286,7608,506,17511,38,625,620,12150,210,7170,659,19320,California
Kings,2021-03-18,587,26331,231,7839,266,17777,90,715,448,12550,139,7309,539,19859,California
Kings,2021-03-19,357,26688,130,7969,214,17991,13,728,291,12789,66,7375,305,20164,California
San Benito,2020-12-16,2,2,2,2,0,0,0,0,2,2,0,0,2,2,California
San Benito,2020-12-17,9,11,9,11,0,0,0,0,9,11,0,0,9,11,California
San Benito,2020-12-18,33,44,33,44,0,0,0,0,33,44,0,0,33,44,California
San Benito,2020-12-19,48,92,48,92,0,0,0,0,48,92,0,0,48,92,California
San Benito,2020-12-20,22,114,21,113,1,1,0,0,22,114,0,0,22,114,California
San Benito,2020-12-21,47,161,47,160,0,1,0,0,47,161,0,0,47,161,California
San Benito,2020-12-22,59,220,59,219,0,1,0,0,59,220,0,0,59,220,California
San Benito,2020-12-23,48,268,36,255,12,13,0,0,48,268,0,0,48,268,California
San Benito,2020-12-24,12,280,4,259,8,21,0,0,12,280,0,0,12,280,California
San Benito,2020-12-25,4,284,4,263,0,21,0,0,4,284,0,0,4,284,California
San Benito,2020-12-26,13,297,4,267,9,30,0,0,13,297,0,0,13,297,California
San Benito,2020-12-27,8,305,7,274,1,31,0,0,8,305,0,0,8,305,California
San Benito,2020-12-28,63,368,36,310,27,58,0,0,63,368,0,0,63,368,California
San Benito,2020-12-29,48,416,19,329,29,87,0,0,48,416,0,0,48,416,California
San Benito,2020-12-30,59,475,36,365,23,110,0,0,59,475,0,0,59,475,California
San Benito,2020-12-31,19,494,2,367,17,127,0,0,19,494,0,0,19,494,California
San Benito,2021-01-02,25,519,24,391,1,128,0,0,25,519,0,0,25,519,California
San Benito,2021-01-03,3,522,1,392,2,130,0,0,3,522,0,0,3,522,California
San Benito,2021-01-04,62,584,23,415,39,169,0,0,62,584,0,0,62,584,California
San Benito,2021-01-05,118,702,36,451,82,251,0,0,115,696,3,3,115,699,California
San Benito,2021-01-06,95,797,40,491,55,306,0,0,81,763,14,17,81,780,California
San Benito,2021-01-07,77,874,41,532,36,342,0,0,51,788,26,43,51,831,California
San Benito,2021-01-08,128,1002,66,598,62,404,0,0,86,832,42,85,86,917,California
San Benito,2021-01-09,44,1046,32,630,12,416,0,0,29,846,15,100,29,946,California
San Benito,2021-01-10,16,1062,14,644,2,418,0,0,5,840,11,111,5,951,California
San Benito,2021-01-11,97,1159,54,698,43,461,0,0,49,841,48,159,49,1000,California
San Benito,2021-01-12,153,1312,51,749,102,563,0,0,118,924,35,194,118,1118,California
San Benito,2021-01-13,186,1498,33,782,153,716,0,0,161,1060,25,219,161,1279,California
San Benito,2021-01-14,116,1614,27,809,89,805,0,0,97,1138,19,238,97,1376,California
San Benito,2021-01-15,212,1826,21,830,191,996,0,0,198,1322,14,252,198,1574,California
San Benito,2021-01-16,29,1855,10,840,19,1015,0,0,23,1339,6,258,23,1597,California
San Benito,2021-01-17,10,1865,5,845,5,1020,0,0,7,1343,3,261,7,1604,California
San Benito,2021-01-18,38,1903,24,869,14,1034,0,0,22,1349,16,277,22,1626,California
San Benito,2021-01-19,148,2051,62,931,86,1120,0,0,123,1447,25,302,123,1749,California
San Benito,2021-01-20,262,2313,82,1013,180,1300,0,0,217,1620,44,346,217,1966,California
San Benito,2021-01-21,123,2436,30,1043,93,1393,0,0,99,1695,24,370,99,2065,California
San Benito,2021-01-22,230,2666,20,1063,210,1603,0,0,219,1903,11,381,219,2284,California
San Benito,2021-01-23,32,2698,18,1081,14,1617,0,0,14,1899,18,399,14,2298,California
San Benito,2021-01-24,11,2709,3,1084,8,1625,0,0,7,1902,4,403,7,2305,California
San Benito,2021-01-25,67,2776,25,1109,42,1667,0,0,22,1879,45,448,22,2327,California
San Benito,2021-01-26,135,2911,41,1150,94,1761,0,0,82,1908,53,501,82,2409,California
San Benito,2021-01-27,231,3142,69,1219,162,1923,0,0,190,2057,41,542,190,2599,California
San Benito,2021-01-28,152,3294,30,1249,122,2045,0,0,121,2148,30,572,121,2720,California
San Benito,2021-01-29,286,3580,32,1281,254,2299,0,0,262,2387,23,595,262,2982,California
San Benito,2021-01-30,45,3625,27,1308,18,2317,0,0,26,2394,19,614,26,3008,California
San Benito,2021-01-31,22,3647,10,1318,12,2329,0,0,12,2397,9,623,12,3020,California
San Benito,2021-02-01,133,3780,29,1347,104,2433,0,0,87,2438,46,669,87,3107,California
San Benito,2021-02-02,222,4002,47,1394,175,2608,0,0,132,2480,90,759,132,3239,California
San Benito,2021-02-03,328,4330,41,1435,287,2895,0,0,264,2680,64,823,264,3503,California
San Benito,2021-02-04,159,4489,24,1459,135,3030,0,0,116,2753,43,866,116,3619,California
San Benito,2021-02-05,289,4778,40,1499,249,3279,0,0,229,2922,60,926,229,3848,California
San Benito,2021-02-06,50,4828,10,1509,40,3319,0,0,34,2940,16,942,34,3882,California
San Benito,2021-02-07,14,4842,6,1515,8,3327,0,0,13,2952,1,943,13,3895,California
San Benito,2021-02-08,130,4972,15,1530,115,3442,0,0,85,2992,45,988,85,3980,California
San Benito,2021-02-09,323,5295,63,1593,260,3702,0,0,192,3053,131,1119,192,4172,California
San Benito,2021-02-10,319,5614,91,1684,228,3930,0,0,125,2985,193,1312,125,4297,California
San Benito,2021-02-11,282,5896,28,1712,254,4184,0,0,190,3083,92,1404,190,4487,California
San Benito,2021-02-12,402,6298,30,1742,372,4556,0,0,203,3088,198,1602,203,4690,California
San Benito,2021-02-13,60,6358,9,1751,51,4607,0,0,45,3118,15,1617,45,4735,California
San Benito,2021-02-14,40,6398,5,1756,35,4642,0,0,30,3138,10,1627,30,4765,California
San Benito,2021-02-15,105,6503,9,1765,96,4738,0,0,94,3221,11,1638,94,4859,California
San Benito,2021-02-16,201,6704,11,1776,190,4928,0,0,104,3227,98,1736,104,4963,California
San Benito,2021-02-17,309,7013,29,1805,280,5208,0,0,263,3444,46,1782,263,5226,California
San Benito,2021-02-18,286,7299,35,1840,251,5459,0,0,66,3290,220,2002,66,5292,California
San Benito,2021-02-19,313,7612,39,1879,274,5733,0,0,149,3275,164,2166,149,5441,California
San Benito,2021-02-20,41,7653,24,1903,17,5750,0,0,32,3298,9,2175,32,5473,California
San Benito,2021-02-21,23,7676,9,1912,14,5764,0,0,14,3304,8,2183,14,5487,California
San Benito,2021-02-22,104,7780,31,1943,73,5837,0,0,72,3344,32,2215,72,5559,California
San Benito,2021-02-23,345,8125,83,2026,262,6099,0,0,218,3454,127,2342,237,5796,California
San Benito,2021-02-24,356,8481,53,2079,303,6402,0,0,222,3543,133,2475,222,6018,California
San Benito,2021-02-25,384,8865,59,2138,325,6727,0,0,262,3684,122,2597,263,6281,California
San Benito,2021-02-26,605,9470,62,2200,543,7270,0,0,364,3807,241,2838,364,6645,California
San Benito,2021-02-27,96,9566,34,2234,62,7332,0,0,81,3873,15,2853,81,6726,California
San Benito,2021-02-28,218,9784,17,2251,201,7533,0,0,210,4075,8,2861,210,6936,California
San Benito,2021-03-01,216,10000,57,2308,159,7692,0,0,149,4157,67,2928,149,7085,California
San Benito,2021-03-02,242,10242,68,2376,174,7866,0,0,179,4273,63,2991,179,7264,California
San Benito,2021-03-03,368,10610,48,2424,320,8186,0,0,197,4301,169,3160,197,7461,California
San Benito,2021-03-04,375,10985,106,2530,269,8455,0,0,262,4451,113,3273,263,7724,California
San Benito,2021-03-05,539,11524,284,2814,240,8695,15,15,335,4598,203,3476,350,8074,California
San Benito,2021-03-06,162,11686,59,2873,90,8785,13,28,116,4681,46,3522,129,8203,California
San Benito,2021-03-07,610,12296,570,3443,18,8803,22,50,577,5247,33,3555,599,8802,California
San Benito,2021-03-08,253,12549,60,3503,169,8972,24,74,153,5325,100,3655,178,8980,California
San Benito,2021-03-09,247,12796,76,3579,108,9080,63,137,122,5386,125,3780,186,9166,California
San Benito,2021-03-10,370,13166,103,3682,177,9257,90,227,209,5523,161,3941,298,9464,California
San Benito,2021-03-11,396,13562,99,3781,194,9451,103,330,186,5602,210,4151,289,9753,California
San Benito,2021-03-12,452,14014,118,3899,269,9720,65,395,221,5660,229,4380,287,10040,California
San Benito,2021-03-13,161,14175,87,3986,61,9781,13,408,101,5717,57,4437,114,10154,California
San Benito,2021-03-14,203,14378,39,4025,144,9925,20,428,166,5867,36,4473,186,10340,California
San Benito,2021-03-15,305,14683,90,4115,196,10121,19,447,182,5945,123,4596,201,10541,California
San Benito,2021-03-16,445,15128,200,4315,215,10336,30,477,303,6137,142,4738,334,10875,California
San Benito,2021-03-17,569,15697,389,4704,168,10504,12,489,460,6502,107,4845,472,11347,California
San Benito,2021-03-18,364,16061,284,4988,62,10566,18,507,297,6750,67,4912,315,11662,California
San Benito,2021-03-19,347,16408,253,5241,85,10651,9,516,289,6990,58,4970,298,11960,California
Modoc,2020-12-16,1,1,1,1,0,0,0,0,1,1,0,0,1,1,California
Modoc,2020-12-21,100,101,100,101,0,0,0,0,100,101,0,0,100,101,California
Modoc,2020-12-22,14,115,14,115,0,0,0,0,14,115,0,0,14,115,California
Modoc,2020-12-23,4,119,4,119,0,0,0,0,4,119,0,0,4,119,California
Modoc,2020-12-24,1,120,1,120,0,0,0,0,1,120,0,0,1,120,California
Modoc,2020-12-28,2,122,2,122,0,0,0,0,2,122,0,0,2,122,California
Modoc,2020-12-29,10,132,1,123,9,9,0,0,10,132,0,0,10,132,California
Modoc,2020-12-30,7,139,0,123,7,16,0,0,7,139,0,0,7,139,California
Modoc,2021-01-02,2,141,0,123,2,18,0,0,2,141,0,0,2,141,California
Modoc,2021-01-04,8,149,0,123,8,26,0,0,8,149,0,0,8,149,California
Modoc,2021-01-05,3,152,2,125,1,27,0,0,3,152,0,0,3,152,California
Modoc,2021-01-06,3,155,2,127,1,28,0,0,2,153,1,1,2,154,California
Modoc,2021-01-07,72,227,0,127,72,100,0,0,72,225,0,1,72,226,California
Modoc,2021-01-08,105,332,0,127,105,205,0,0,105,330,0,1,105,331,California
Modoc,2021-01-10,1,333,1,128,0,205,0,0,0,329,1,2,0,331,California
Modoc,2021-01-11,92,425,82,210,10,215,0,0,19,275,73,75,19,350,California
Modoc,2021-01-12,94,519,25,235,69,284,0,0,68,317,26,101,68,418,California
Modoc,2021-01-13,24,543,4,239,20,304,0,0,22,337,2,103,22,440,California
Modoc,2021-01-14,129,672,6,245,123,427,0,0,124,456,5,108,124,564,California
Modoc,2021-01-15,6,678,1,246,5,432,0,0,6,462,0,108,6,570,California
Modoc,2021-01-16,1,679,1,247,0,432,0,0,1,463,0,108,1,571,California
Modoc,2021-01-18,1,680,1,248,0,432,0,0,1,464,0,108,1,572,California
Modoc,2021-01-19,5,685,3,251,2,434,0,0,3,465,2,110,3,575,California
Modoc,2021-01-20,11,696,1,252,10,444,0,0,11,476,0,110,11,586,California
Modoc,2021-01-21,158,854,2,254,156,600,0,0,158,634,0,110,158,744,California
Modoc,2021-01-22,2,856,0,254,2,602,0,0,2,636,0,110,2,746,California
Modoc,2021-01-25,12,868,1,255,11,613,0,0,12,648,0,110,12,758,California
Modoc,2021-01-26,66,934,2,257,64,677,0,0,65,712,1,111,65,823,California
Modoc,2021-01-27,41,975,2,259,39,716,0,0,25,721,16,127,25,848,California
Modoc,2021-01-28,144,1119,1,260,143,859,0,0,144,865,0,127,144,992,California
Modoc,2021-01-29,3,1122,1,261,2,861,0,0,3,868,0,127,3,995,California
Modoc,2021-02-01,24,1146,11,272,13,874,0,0,11,866,13,140,11,1006,California
Modoc,2021-02-02,170,1316,2,274,168,1042,0,0,167,1030,3,143,167,1173,California
Modoc,2021-02-03,18,1334,13,287,5,1047,0,0,11,1034,7,150,11,1184,California
Modoc,2021-02-04,154,1488,3,290,151,1198,0,0,26,932,128,278,26,1210,California
Modoc,2021-02-05,4,1492,3,293,1,1199,0,0,3,934,1,279,3,1213,California
Modoc,2021-02-08,9,1501,2,295,7,1206,0,0,8,941,1,280,8,1221,California
Modoc,2021-02-09,197,1698,12,307,185,1391,0,0,65,874,132,412,65,1286,California
Modoc,2021-02-10,5,1703,2,309,3,1394,0,0,4,877,1,413,4,1290,California
Modoc,2021-02-11,201,1904,3,312,198,1592,0,0,83,842,118,531,83,1373,California
Modoc,2021-02-12,5,1909,1,313,4,1596,0,0,3,843,2,533,3,1376,California
Modoc,2021-02-13,1,1910,0,313,1,1597,0,0,1,844,0,533,1,1377,California
Modoc,2021-02-16,141,2051,0,313,141,1738,0,0,138,979,3,536,138,1515,California
Modoc,2021-02-17,22,2073,1,314,21,1759,0,0,11,979,11,547,11,1526,California
Modoc,2021-02-18,189,2262,2,316,187,1946,0,0,26,843,162,709,26,1552,California
Modoc,2021-02-19,1,2263,0,316,1,1947,0,0,1,844,0,709,1,1553,California
Modoc,2021-02-20,1,2264,1,317,0,1947,0,0,1,845,0,709,1,1554,California
Modoc,2021-02-22,16,2280,8,325,8,1955,0,0,3,835,13,722,3,1557,California
Modoc,2021-02-23,23,2303,4,329,19,1974,0,0,3,818,20,742,3,1560,California
Modoc,2021-02-24,90,2393,1,330,89,2063,0,0,30,788,60,802,30,1590,California
Modoc,2021-02-25,169,2562,1,331,168,2231,0,0,13,645,156,958,13,1603,California
Modoc,2021-02-26,3,2565,0,331,3,2234,0,0,1,644,2,960,1,1604,California
Modoc,2021-02-27,5,2570,5,336,0,2234,0,0,2,643,3,963,2,1606,California
Modoc,2021-03-01,4,2574,0,336,4,2238,0,0,0,639,4,967,0,1606,California
Modoc,2021-03-02,187,2761,11,347,176,2414,0,0,22,496,165,1132,22,1628,California
Modoc,2021-03-03,10,2771,6,353,4,2418,0,0,2,490,8,1140,2,1630,California
Modoc,2021-03-04,155,2926,2,355,153,2571,0,0,130,595,25,1165,130,1760,California
Modoc,2021-03-05,3,2929,2,357,1,2572,0,0,1,594,2,1167,1,1761,California
Modoc,2021-03-06,10,2939,0,357,0,2572,10,10,0,594,10,1177,10,1771,California
Modoc,2021-03-07,6,2945,1,358,0,2572,5,15,1,595,5,1182,6,1777,California
Modoc,2021-03-08,5,2950,0,358,1,2573,4,19,0,594,5,1187,4,1781,California
Modoc,2021-03-09,120,3070,8,366,104,2677,8,27,62,606,58,1245,70,1851,California
Modoc,2021-03-10,6,3076,3,369,2,2679,1,28,4,609,2,1247,5,1856,California
Modoc,2021-03-11,164,3240,0,369,79,2758,85,113,15,560,149,1396,100,1956,California
Modoc,2021-03-12,7,3247,0,369,4,2762,3,116,4,564,3,1399,7,1963,California
Modoc,2021-03-13,4,3251,0,369,1,2763,3,119,1,565,3,1402,4,1967,California
Modoc,2021-03-14,1,3252,0,369,0,2763,1,120,0,565,1,1403,1,1968,California
Modoc,2021-03-15,11,3263,1,370,9,2772,1,121,10,575,1,1404,11,1979,California
Modoc,2021-03-16,145,3408,1,371,142,2914,2,123,30,492,115,1519,32,2011,California
Modoc,2021-03-17,8,3416,1,372,4,2918,3,126,2,491,6,1525,5,2016,California
Modoc,2021-03-18,52,3468,2,374,50,2968,0,126,28,495,24,1549,28,2044,California
Modoc,2021-03-19,2,3470,0,374,2,2970,0,126,0,493,2,1551,0,2044,California
Tulare,2020-12-16,3,3,3,3,0,0,0,0,3,3,0,0,3,3,California
Tulare,2020-12-17,109,112,109,112,0,0,0,0,109,112,0,0,109,112,California
Tulare,2020-12-18,292,404,292,404,0,0,0,0,292,404,0,0,292,404,California
Tulare,2020-12-19,327,731,327,731,0,0,0,0,327,731,0,0,327,731,California
Tulare,2020-12-20,167,898,167,898,0,0,0,0,167,898,0,0,167,898,California
Tulare,2020-12-21,422,1320,422,1320,0,0,0,0,442,1340,0,0,442,1340,California
Tulare,2020-12-22,469,1789,467,1787,2,2,0,0,468,1808,0,0,468,1808,California
Tulare,2020-12-23,329,2118,322,2109,7,9,0,0,327,2135,0,0,327,2135,California
Tulare,2020-12-24,18,2136,16,2125,2,11,0,0,18,2153,0,0,18,2153,California
Tulare,2020-12-26,9,2145,7,2132,2,13,0,0,9,2162,0,0,9,2162,California
Tulare,2020-12-27,15,2160,12,2144,3,16,0,0,15,2177,0,0,15,2177,California
Tulare,2020-12-28,484,2644,472,2616,12,28,0,0,483,2660,0,0,483,2660,California
Tulare,2020-12-29,544,3188,477,3093,67,95,0,0,544,3204,0,0,544,3204,California
Tulare,2020-12-30,472,3660,435,3528,37,132,0,0,472,3676,0,0,472,3676,California
Tulare,2020-12-31,94,3754,22,3550,72,204,0,0,94,3770,0,0,94,3770,California
Tulare,2021-01-02,27,3781,18,3568,9,213,0,0,27,3797,0,0,27,3797,California
Tulare,2021-01-03,22,3803,9,3577,13,226,0,0,22,3819,0,0,22,3819,California
Tulare,2021-01-04,92,3895,16,3593,76,302,0,0,92,3911,0,0,92,3911,California
Tulare,2021-01-05,462,4357,279,3872,183,485,0,0,460,4370,2,2,461,4372,California
Tulare,2021-01-06,862,5219,636,4508,226,711,0,0,852,5212,10,12,852,5224,California
Tulare,2021-01-07,779,5998,581,5089,198,909,0,0,673,5779,106,118,673,5897,California
Tulare,2021-01-08,1264,7262,575,5664,689,1598,0,0,926,6368,337,455,926,6823,California
Tulare,2021-01-09,738,8000,203,5867,535,2133,0,0,551,6732,187,642,551,7374,California
Tulare,2021-01-10,49,8049,43,5910,6,2139,0,0,10,6703,39,681,10,7384,California
Tulare,2021-01-11,1200,9249,765,6675,435,2574,0,0,765,7033,435,1116,765,8149,California
Tulare,2021-01-12,1390,10639,486,7161,904,3478,0,0,984,7611,406,1522,984,9133,California
Tulare,2021-01-13,451,11090,227,7388,224,3702,0,0,376,7912,75,1597,376,9509,California
Tulare,2021-01-14,491,11581,141,7529,350,4052,0,0,465,8362,15,1612,465,9974,California
Tulare,2021-01-15,1601,13182,148,7677,1453,5505,0,0,1592,9945,9,1621,1592,11566,California
Tulare,2021-01-16,1872,15054,113,7790,1759,7264,0,0,1859,11791,13,1634,1859,13425,California
Tulare,2021-01-17,139,15193,121,7911,18,7282,0,0,129,11910,10,1644,129,13554,California
Tulare,2021-01-18,695,15888,662,8573,33,7315,0,0,294,11803,401,2045,294,13848,California
Tulare,2021-01-19,1003,16891,681,9254,322,7637,0,0,577,11954,426,2471,577,14425,California
Tulare,2021-01-20,2366,19257,556,9810,1810,9447,0,0,1987,13562,379,2850,1987,16412,California
Tulare,2021-01-21,1503,20760,149,9959,1354,10801,0,0,1479,15021,20,2870,1479,17891,California
Tulare,2021-01-22,1049,21809,185,10144,864,11665,0,0,1024,16021,24,2894,1024,18915,California
Tulare,2021-01-23,440,22249,157,10301,283,11948,0,0,417,16415,23,2917,417,19332,California
Tulare,2021-01-24,29,22278,27,10328,2,11950,0,0,27,16440,2,2919,27,19359,California
Tulare,2021-01-25,1295,23573,949,11277,346,12296,0,0,1269,17683,26,2945,1269,20628,California
Tulare,2021-01-26,1495,25068,1099,12376,396,12692,0,0,1171,18531,323,3268,1171,21799,California
Tulare,2021-01-27,1455,26523,1070,13446,385,13077,0,0,875,18826,580,3848,875,22674,California
Tulare,2021-01-28,1187,27710,761,14207,426,13503,0,0,796,19231,391,4239,796,23470,California
Tulare,2021-01-29,1119,28829,716,14923,403,13906,0,0,812,19736,307,4546,812,24282,California
Tulare,2021-01-30,1671,30500,1581,16504,90,13996,0,0,1648,21362,23,4569,1649,25931,California
Tulare,2021-01-31,50,30550,47,16551,3,13999,0,0,48,21408,2,4571,48,25979,California
Tulare,2021-02-01,1164,31714,902,17453,262,14261,0,0,816,21877,347,4918,816,26795,California
Tulare,2021-02-02,669,32383,328,17781,341,14602,0,0,440,22090,227,5145,440,27235,California
Tulare,2021-02-03,602,32985,282,18063,320,14922,0,0,330,22150,270,5415,330,27565,California
Tulare,2021-02-04,551,33536,165,18228,386,15308,0,0,265,22130,286,5701,266,27831,California
Tulare,2021-02-05,1226,34762,228,18456,998,16306,0,0,414,21734,810,6511,414,28245,California
Tulare,2021-02-06,834,35596,151,18607,683,16989,0,0,274,21450,558,7069,274,28519,California
Tulare,2021-02-07,76,35672,64,18671,12,17001,0,0,23,21420,53,7122,23,28542,California
Tulare,2021-02-08,945,36617,335,19006,610,17611,0,0,309,21096,633,7755,309,28851,California
Tulare,2021-02-09,1399,38016,320,19326,1079,18690,0,0,361,20423,1034,8789,361,29212,California
Tulare,2021-02-10,2441,40457,1980,21306,461,19151,0,0,2063,22111,375,9164,2063,31275,California
Tulare,2021-02-11,1278,41735,368,21674,910,20061,0,0,900,22634,377,9541,900,32175,California
Tulare,2021-02-12,2766,44501,575,22249,2191,22252,0,0,1218,22312,1541,11082,1219,33394,California
Tulare,2021-02-13,2443,46944,155,22404,2288,24540,0,0,664,21199,1777,12859,664,34058,California
Tulare,2021-02-14,328,47272,36,22440,292,24832,0,0,294,21459,34,12893,294,34352,California
Tulare,2021-02-15,901,48173,285,22725,616,25448,0,0,650,21859,250,13143,650,35002,California
Tulare,2021-02-16,2780,50953,1600,24325,1180,26628,0,0,1050,21179,1730,14873,1050,36052,California
Tulare,2021-02-17,2673,53626,502,24827,2171,28799,0,0,455,19420,2214,17087,455,36507,California
Tulare,2021-02-18,2242,55868,423,25250,1819,30618,0,0,592,18370,1642,18729,592,37099,California
Tulare,2021-02-19,2247,58115,826,26076,1421,32039,0,0,932,17989,1313,20042,932,38031,California
Tulare,2021-02-20,2882,60997,1863,27939,1019,33058,0,0,1178,17468,1699,21741,1178,39209,California
Tulare,2021-02-21,41,61038,37,27976,4,33062,0,0,27,17481,14,21755,27,39236,California
Tulare,2021-02-22,1060,62098,654,28630,406,33468,0,0,208,16839,851,22606,209,39445,California
Tulare,2021-02-23,1654,63752,693,29323,961,34429,0,0,1170,17527,483,23089,1171,40616,California
Tulare,2021-02-24,2314,66066,1487,30810,827,35256,0,0,1945,19105,368,23457,1946,42562,California
Tulare,2021-02-25,3194,69260,1771,32581,1423,36679,0,0,2784,21484,405,23862,2784,45346,California
Tulare,2021-02-26,3328,72588,1708,34289,1620,38299,0,0,2937,24033,388,24250,2937,48283,California
Tulare,2021-02-27,2672,75260,1366,35655,1306,39605,0,0,2548,26468,114,24364,2549,50832,California
Tulare,2021-02-28,1222,76482,989,36644,233,39838,0,0,1203,27655,16,24380,1203,52035,California
Tulare,2021-03-01,1567,78049,706,37350,861,40699,0,0,1392,28875,174,24554,1394,53429,California
Tulare,2021-03-02,2312,80361,1037,38387,1275,41974,0,0,2160,30888,148,24702,2161,55590,California
Tulare,2021-03-03,3199,83560,2206,40593,993,42967,0,0,1493,30676,1705,26407,1493,57083,California
Tulare,2021-03-04,2621,86181,1242,41835,1379,44346,0,0,2319,32699,298,26705,2321,59404,California
Tulare,2021-03-05,3040,89221,1589,43424,1438,45784,13,13,2586,34850,450,27155,2601,62005,California
Tulare,2021-03-06,2821,92042,1346,44770,1419,47203,56,69,2580,37244,240,27395,2634,64639,California
Tulare,2021-03-07,1035,93077,634,45404,383,47586,18,87,1004,38235,31,27426,1022,65661,California
Tulare,2021-03-08,1179,94256,628,46032,405,47991,146,233,932,39067,246,27672,1078,66739,California
Tulare,2021-03-09,1894,96150,1007,47039,741,48732,146,379,1567,40454,327,27999,1714,68453,California
Tulare,2021-03-10,2133,98283,1040,48079,981,49713,112,491,1824,42091,299,28298,1936,70389,California
Tulare,2021-03-11,3532,101815,1704,49783,1601,51314,227,718,2703,44196,825,29123,2930,73319,California
Tulare,2021-03-12,3581,105396,1985,51768,1335,52649,261,979,2566,46019,1003,30126,2826,76145,California
Tulare,2021-03-13,3382,108778,1596,53364,1687,54336,99,1078,2654,48045,726,30852,2752,78897,California
Tulare,2021-03-14,1552,110330,868,54232,477,54813,207,1285,1185,49072,365,31217,1392,80289,California
Tulare,2021-03-15,2490,112820,1463,55695,911,55724,116,1401,1745,50188,745,31962,1861,82150,California
Tulare,2021-03-16,3185,116005,1972,57667,1136,56860,77,1478,1951,50989,1230,33192,2031,84181,California
Tulare,2021-03-17,2807,118812,1807,59474,951,57811,49,1527,1748,51733,1054,34246,1798,85979,California
Tulare,2021-03-18,2855,121667,2148,61622,677,58488,30,1557,1584,52078,1268,35514,1613,87592,California
Tulare,2021-03-19,1783,123450,1325,62947,426,58914,32,1589,989,52307,791,36305,1020,88612,California
Fresno,2020-12-15,1,1,1,1,0,0,0,0,1,1,0,0,1,1,California
Fresno,2020-12-16,120,121,120,121,0,0,0,0,120,121,0,0,120,121,California
Fresno,2020-12-17,119,240,119,240,0,0,0,0,119,240,0,0,119,240,California
Fresno,2020-12-18,343,583,343,583,0,0,0,0,343,583,0,0,343,583,California
Fresno,2020-12-19,158,741,158,741,0,0,0,0,158,741,0,0,158,741,California
Fresno,2020-12-20,254,995,254,995,0,0,0,0,254,995,0,0,254,995,California
Fresno,2020-12-21,926,1921,925,1920,1,1,0,0,958,1953,0,0,958,1953,California
Fresno,2020-12-22,903,2824,875,2795,28,29,0,0,907,2860,0,0,907,2860,California
Fresno,2020-12-23,1080,3904,1051,3846,29,58,0,0,1081,3941,0,0,1081,3941,California
Fresno,2020-12-24,576,4480,563,4409,13,71,0,0,576,4517,0,0,576,4517,California
Fresno,2020-12-25,3,4483,2,4411,1,72,0,0,3,4520,0,0,3,4520,California
Fresno,2020-12-26,720,5203,712,5123,8,80,0,0,720,5240,0,0,720,5240,California
Fresno,2020-12-27,297,5500,204,5327,93,173,0,0,297,5537,0,0,297,5537,California
Fresno,2020-12-28,1058,6558,772,6099,286,459,0,0,1058,6595,0,0,1058,6595,California
Fresno,2020-12-29,1771,8329,1037,7136,734,1193,0,0,1769,8363,1,1,1769,8364,California
Fresno,2020-12-30,964,9293,472,7608,492,1685,0,0,964,9327,0,1,964,9328,California
Fresno,2020-12-31,890,10183,311,7919,579,2264,0,0,889,10216,0,1,889,10217,California
Fresno,2021-01-01,8,10191,3,7922,5,2269,0,0,8,10224,0,1,8,10225,California
Fresno,2021-01-02,1025,11216,716,8638,309,2578,0,0,1025,11249,0,1,1025,11250,California
Fresno,2021-01-03,152,11368,128,8766,24,2602,0,0,152,11401,0,1,152,11402,California
Fresno,2021-01-04,618,11986,386,9152,232,2834,0,0,616,12017,0,1,616,12018,California
Fresno,2021-01-05,769,12755,310,9462,459,3293,0,0,695,12648,74,75,705,12723,California
Fresno,2021-01-06,961,13716,343,9805,618,3911,0,0,788,13272,173,248,797,13520,California
Fresno,2021-01-07,1868,15584,913,10718,955,4866,0,0,1615,14640,253,501,1621,15141,California
Fresno,2021-01-08,1762,17346,615,11333,1147,6013,0,0,1395,15680,365,866,1405,16546,California
Fresno,2021-01-09,624,17970,387,11720,237,6250,0,0,350,15756,274,1140,350,16896,California
Fresno,2021-01-10,511,18481,484,12204,27,6277,0,0,197,15639,314,1454,197,17093,California
Fresno,2021-01-11,2128,20609,1728,13932,400,6677,0,0,1437,16388,691,2145,1440,18533,California
Fresno,2021-01-12,2494,23103,1809,15741,685,7362,0,0,1648,17190,848,2993,1650,20183,California
Fresno,2021-01-13,3507,26610,2421,18162,1086,8448,0,0,2646,18977,861,3854,2648,22831,California
Fresno,2021-01-14,4117,30727,2202,20364,1915,10363,0,0,3644,22148,473,4327,3644,26475,California
Fresno,2021-01-15,3593,34320,2517,22881,1076,11439,0,0,3235,25029,358,4685,3239,29714,California
Fresno,2021-01-16,3129,37449,2290,25171,839,12278,0,0,2669,27239,460,5145,2670,32384,California
Fresno,2021-01-17,968,38417,553,25724,415,12693,0,0,768,27807,200,5345,768,33152,California
Fresno,2021-01-18,3066,41483,2359,28083,707,13400,0,0,2405,29553,660,6005,2406,35558,California
Fresno,2021-01-19,4270,45753,2519,30602,1751,15151,0,0,3636,32560,634,6639,3641,39199,California
Fresno,2021-01-20,2967,48720,1180,31782,1787,16938,0,0,2677,34950,287,6926,2677,41876,California
Fresno,2021-01-21,4316,53036,1997,33779,2319,19257,0,0,3977,38607,325,7251,3982,45858,California
Fresno,2021-01-22,3289,56325,1342,35121,1947,21204,0,0,2905,41147,368,7619,2908,48766,California
Fresno,2021-01-23,3018,59343,1950,37071,1068,22272,0,0,2294,42723,724,8343,2300,51066,California
Fresno,2021-01-24,550,59893,374,37445,176,22448,0,0,348,42869,202,8545,348,51414,California
Fresno,2021-01-25,2320,62213,861,38306,1459,23907,0,0,1838,44228,482,9027,1841,53255,California
Fresno,2021-01-26,1980,64193,572,38878,1408,25315,0,0,1289,44833,689,9716,1294,54549,California
Fresno,2021-01-27,2223,66416,1150,40028,1073,26388,0,0,1710,46032,512,10228,1711,56260,California
Fresno,2021-01-28,4385,70801,2976,43004,1409,27797,0,0,3388,48428,994,11222,3390,59650,California
Fresno,2021-01-29,1683,72484,980,43984,703,28500,0,0,1383,49516,296,11518,1384,61034,California
Fresno,2021-01-30,1386,73870,509,44493,877,29377,0,0,986,50102,400,11918,986,62020,California
Fresno,2021-01-31,230,74100,219,44712,11,29388,0,0,76,50024,154,12072,76,62096,California
Fresno,2021-02-01,3304,77404,1653,46365,1651,31039,0,0,1711,50232,1593,13665,1801,63897,California
Fresno,2021-02-02,2695,80099,543,46908,2152,33191,0,0,1532,50672,1151,14816,1591,65488,California
Fresno,2021-02-03,3473,83572,2036,48944,1437,34628,0,0,1524,50267,1931,16747,1526,67014,California
Fresno,2021-02-04,4182,87754,1896,50840,2286,36914,0,0,1927,49971,2227,18974,1931,68945,California
Fresno,2021-02-05,5101,92855,2590,53430,2511,39425,0,0,2080,49041,3013,21987,2083,71028,California
Fresno,2021-02-06,2911,95766,2030,55460,881,40306,0,0,960,48054,1948,23935,961,71989,California
Fresno,2021-02-07,453,96219,280,55740,173,40479,0,0,262,48131,190,24125,267,72256,California
Fresno,2021-02-08,4234,100453,2290,58030,1944,42423,0,0,1781,47484,2431,26556,1784,74040,California
Fresno,2021-02-09,5322,105775,2088,60118,3234,45657,0,0,3123,48484,2126,28682,3126,77166,California
Fresno,2021-02-10,3649,109424,1227,61345,2422,48079,0,0,1966,48825,1628,30310,1969,79135,California
Fresno,2021-02-11,6212,115636,2065,63410,4147,52226,0,0,3312,49258,2888,33198,3321,82456,California
Fresno,2021-02-12,4929,120565,1182,64592,3747,55973,0,0,2541,49434,2372,35570,2548,85004,California
Fresno,2021-02-13,3680,124245,1536,66128,2144,58117,0,0,2031,49833,1637,37207,2036,87040,California
Fresno,2021-02-14,1545,125790,283,66411,1262,59379,0,0,825,49947,719,37926,833,87873,California
Fresno,2021-02-15,2834,128624,258,66669,2576,61955,0,0,1737,50592,1094,39020,1739,89612,California
Fresno,2021-02-16,6252,134876,2299,68968,3953,65908,0,0,3914,52200,2324,41344,3932,93544,California
Fresno,2021-02-17,4952,139828,2352,71320,2600,68508,0,0,2747,52806,2166,43510,2772,96316,California
Fresno,2021-02-18,6570,146398,2838,74158,3732,72240,0,0,2521,51352,4005,47515,2551,98867,California
Fresno,2021-02-19,3714,150112,1091,75249,2623,74863,0,0,1786,51427,1916,49431,1991,100858,California
Fresno,2021-02-20,4119,154231,2401,77650,1718,76581,0,0,2959,53255,1156,50587,2984,103842,California
Fresno,2021-02-21,173,154404,158,77808,15,76596,0,0,127,53347,35,50622,127,103969,California
Fresno,2021-02-22,2141,156545,945,78753,1196,77792,0,0,1188,53595,947,51569,1195,105164,California
Fresno,2021-02-23,3599,160144,1369,80122,2230,80022,0,0,2765,55574,827,52396,2806,107970,California
Fresno,2021-02-24,3819,163963,1468,81590,2351,82373,0,0,3095,57973,716,53112,3115,111085,California
Fresno,2021-02-25,6959,170922,2354,83944,4605,86978,0,0,5601,62259,1348,54460,5634,116719,California
Fresno,2021-02-26,7541,178463,2856,86800,4685,91663,0,0,6475,67691,1053,55513,6485,123204,California
Fresno,2021-02-27,6064,184527,2130,88930,3934,95597,0,0,5415,72482,641,56154,5432,128636,California
Fresno,2021-02-28,1493,186020,450,89380,1043,96640,0,0,1417,73839,68,56222,1425,130061,California
Fresno,2021-03-01,4528,190548,1154,90534,3374,100014,0,0,3309,75993,1213,57435,3367,133428,California
Fresno,2021-03-02,7595,198143,2176,92710,5419,105433,0,0,6341,81112,1233,58668,6352,139780,California
Fresno,2021-03-03,5315,203458,1347,94057,3968,109401,0,0,4392,84599,910,59578,4397,144177,California
Fresno,2021-03-04,7621,211079,2158,96215,5463,114864,0,0,6209,89420,1390,60968,6211,150388,California
Fresno,2021-03-05,6809,217888,2557,98772,4251,119115,1,1,5912,94563,770,61738,5913,156301,California
Fresno,2021-03-06,5868,223756,3125,101897,2631,121746,112,113,4957,98728,907,62645,5072,161373,California
Fresno,2021-03-07,1157,224913,452,102349,671,122417,34,147,1004,99614,153,62798,1039,162412,California
Fresno,2021-03-08,4280,229193,1595,103944,2582,124999,103,250,3241,101924,1038,63836,3348,165760,California
Fresno,2021-03-09,6420,235613,2135,106079,4026,129025,259,509,3663,103102,2748,66584,3926,169686,California
Fresno,2021-03-10,5777,241390,2330,108409,3094,132119,353,862,4469,106622,1304,67888,4824,174510,California
Fresno,2021-03-11,10145,251535,3940,112349,5697,137816,508,1370,5605,108222,4519,72407,6119,180629,California
Fresno,2021-03-12,9433,260968,4157,116506,4925,142741,351,1721,7036,113235,2388,74795,7401,188030,California
Fresno,2021-03-13,6457,267425,3556,120062,2214,144955,687,2408,3178,113848,3266,78061,3879,191909,California
Fresno,2021-03-14,1155,268580,379,120441,528,145483,248,2656,480,113905,671,78732,728,192637,California
Fresno,2021-03-15,6524,275104,2780,123221,3587,149070,157,2813,4467,116511,2051,80783,4657,197294,California
Fresno,2021-03-16,9601,284705,4246,127467,5006,154076,349,3162,6139,119564,3446,84229,6499,203793,California
Fresno,2021-03-17,6337,291042,3142,130609,2751,156827,444,3606,4175,122075,2152,86381,4663,208456,California
Fresno,2021-03-18,7018,298060,4312,134921,2390,159217,316,3922,4840,125133,2160,88541,5218,213674,California
Fresno,2021-03-19,3977,302037,2544,137465,1177,160394,256,4178,2273,126011,1697,90238,2575,216249,California
Del Norte,2020-12-21,23,23,23,23,0,0,0,0,23,23,0,0,23,23,California
Del Norte,2020-12-22,46,69,46,69,0,0,0,0,46,69,0,0,46,69,California
Del Norte,2020-12-23,58,127,48,117,10,10,0,0,57,126,0,0,57,126,California
Del Norte,2020-12-28,34,161,34,151,0,10,0,0,34,160,0,0,34,160,California
Del Norte,2020-12-29,4,165,4,155,0,10,0,0,4,164,0,0,4,164,California
Del Norte,2020-12-30,67,232,55,210,12,22,0,0,68,232,0,0,68,232,California
Del Norte,2020-12-31,16,248,13,223,3,25,0,0,16,248,0,0,16,248,California
Del Norte,2021-01-04,102,350,49,272,53,78,0,0,102,350,0,0,102,350,California
Del Norte,2021-01-05,33,383,0,272,33,111,0,0,33,383,0,0,33,383,California
Del Norte,2021-01-06,78,461,18,290,60,171,0,0,78,461,0,0,78,461,California
Del Norte,2021-01-07,21,482,1,291,20,191,0,0,21,482,0,0,21,482,California
Del Norte,2021-01-08,77,559,7,298,70,261,0,0,77,559,0,0,77,559,California
Del Norte,2021-01-11,40,599,21,319,19,280,0,0,18,556,22,22,19,578,California
Del Norte,2021-01-12,50,649,32,351,18,298,0,0,29,564,21,43,29,607,California
Del Norte,2021-01-13,85,734,40,391,45,343,0,0,52,583,33,76,52,659,California
Del Norte,2021-01-14,52,786,14,405,38,381,0,0,46,623,6,82,46,705,California
Del Norte,2021-01-15,107,893,18,423,89,470,0,0,95,706,12,94,95,800,California
Del Norte,2021-01-17,1,894,1,424,0,470,0,0,1,707,0,94,1,801,California
Del Norte,2021-01-18,2,896,0,424,2,472,0,0,2,709,0,94,2,803,California
Del Norte,2021-01-19,119,1015,56,480,63,535,0,0,77,744,42,136,77,880,California
Del Norte,2021-01-20,157,1172,83,563,74,609,0,0,96,779,61,197,96,976,California
Del Norte,2021-01-21,43,1215,40,603,3,612,0,0,32,800,11,208,32,1008,California
Del Norte,2021-01-22,19,1234,16,619,3,615,0,0,12,805,7,215,12,1020,California
Del Norte,2021-01-23,1,1235,0,619,1,616,0,0,1,806,0,215,1,1021,California
Del Norte,2021-01-24,1,1236,0,619,1,617,0,0,1,807,0,215,1,1022,California
Del Norte,2021-01-25,97,1333,79,698,18,635,0,0,53,816,44,259,53,1075,California
Del Norte,2021-01-26,18,1351,11,709,7,642,0,0,7,812,11,270,7,1082,California
Del Norte,2021-01-27,62,1413,21,730,41,683,0,0,59,868,3,273,59,1141,California
Del Norte,2021-01-28,291,1704,20,750,271,954,0,0,287,1151,4,277,287,1428,California
Del Norte,2021-01-29,49,1753,18,768,31,985,0,0,41,1184,8,285,41,1469,California
Del Norte,2021-01-30,8,1761,1,769,7,992,0,0,8,1192,0,285,8,1477,California
Del Norte,2021-02-01,40,1801,1,770,39,1031,0,0,25,1202,15,300,25,1502,California
Del Norte,2021-02-02,142,1943,34,804,108,1139,0,0,73,1207,68,368,73,1575,California
Del Norte,2021-02-03,126,2069,40,844,86,1225,0,0,71,1223,55,423,71,1646,California
Del Norte,2021-02-04,70,2139,28,872,42,1267,0,0,41,1235,29,452,41,1687,California
Del Norte,2021-02-05,134,2273,22,894,112,1379,0,0,103,1308,30,482,103,1790,California
Del Norte,2021-02-06,266,2539,5,899,261,1640,0,0,266,1574,0,482,266,2056,California
Del Norte,2021-02-07,4,2543,3,902,1,1641,0,0,4,1578,0,482,4,2060,California
Del Norte,2021-02-08,36,2579,1,903,35,1676,0,0,32,1606,4,486,32,2092,California
Del Norte,2021-02-09,7,2586,5,908,2,1678,0,0,1,1601,6,492,1,2093,California
Del Norte,2021-02-10,138,2724,20,928,118,1796,0,0,81,1626,56,548,81,2174,California
Del Norte,2021-02-11,175,2899,58,986,117,1913,0,0,63,1577,112,660,63,2237,California
Del Norte,2021-02-12,115,3014,9,995,106,2019,0,0,61,1584,54,714,61,2298,California
Del Norte,2021-02-13,2,3016,1,996,1,2020,0,0,2,1586,0,714,2,2300,California
Del Norte,2021-02-14,3,3019,1,997,2,2022,0,0,2,1587,1,715,2,2302,California
Del Norte,2021-02-15,4,3023,0,997,4,2026,0,0,2,1587,2,717,2,2304,California
Del Norte,2021-02-16,131,3154,1,998,130,2156,0,0,13,1482,118,835,13,2317,California
Del Norte,2021-02-17,90,3244,19,1017,71,2227,0,0,23,1438,67,902,23,2340,California
Del Norte,2021-02-18,76,3320,24,1041,52,2279,0,0,50,1462,26,928,50,2390,California
Del Norte,2021-02-19,44,3364,17,1058,27,2306,0,0,34,1486,10,938,34,2424,California
Del Norte,2021-02-20,7,3371,5,1063,2,2308,0,0,6,1491,1,939,6,2430,California
Del Norte,2021-02-22,2,3373,0,1063,2,2310,0,0,2,1493,0,939,2,2432,California
Del Norte,2021-02-23,101,3474,83,1146,18,2328,0,0,30,1452,71,1010,30,2462,California
Del Norte,2021-02-24,149,3623,96,1242,53,2381,0,0,77,1457,72,1082,77,2539,California
Del Norte,2021-02-25,449,4072,114,1356,335,2716,0,0,191,1390,258,1340,191,2730,California
Del Norte,2021-02-26,99,4171,63,1419,36,2752,0,0,53,1397,46,1386,53,2783,California
Del Norte,2021-02-27,152,4323,144,1563,8,2760,0,0,144,1533,8,1394,144,2927,California
Del Norte,2021-02-28,6,4329,3,1566,3,2763,0,0,3,1533,3,1397,3,2930,California
Del Norte,2021-03-01,26,4355,2,1568,24,2787,0,0,4,1515,22,1419,4,2934,California
Del Norte,2021-03-02,210,4565,140,1708,70,2857,0,0,178,1661,32,1451,178,3112,California
Del Norte,2021-03-03,150,4715,90,1798,60,2917,0,0,110,1731,40,1491,110,3222,California
Del Norte,2021-03-04,120,4835,83,1881,37,2954,0,0,90,1792,29,1520,90,3312,California
Del Norte,2021-03-05,68,4903,8,1889,60,3014,0,0,34,1792,34,1554,34,3346,California
Del Norte,2021-03-06,425,5328,79,1968,296,3310,50,50,154,1682,271,1825,161,3507,California
Del Norte,2021-03-07,3,5331,2,1970,1,3311,0,50,2,1683,1,1826,2,3509,California
Del Norte,2021-03-08,23,5354,1,1971,20,3331,2,52,4,1670,19,1845,6,3515,California
Del Norte,2021-03-09,145,5499,70,2041,71,3402,4,56,135,1799,10,1855,139,3654,California
Del Norte,2021-03-10,122,5621,11,2052,85,3487,26,82,49,1801,73,1928,75,3729,California
Del Norte,2021-03-11,142,5763,49,2101,91,3578,2,84,97,1855,45,1973,99,3828,California
Del Norte,2021-03-12,160,5923,90,2191,70,3648,0,84,115,1925,45,2018,115,3943,California
Del Norte,2021-03-13,93,6016,91,2282,2,3650,0,84,89,2010,4,2022,89,4032,California
Del Norte,2021-03-14,1,6017,0,2282,0,3650,1,85,0,2010,1,2023,1,4033,California
Del Norte,2021-03-15,39,6056,0,2282,38,3688,1,86,34,2040,5,2028,35,4068,California
Del Norte,2021-03-16,187,6243,128,2410,57,3745,2,88,168,2191,19,2047,170,4238,California
Del Norte,2021-03-17,174,6417,49,2459,124,3869,1,89,108,2234,66,2113,109,4347,California
Del Norte,2021-03-18,113,6530,3,2462,107,3976,3,92,83,2290,30,2143,86,4433,California
Del Norte,2021-03-19,45,6575,1,2463,43,4019,1,93,35,2316,10,2153,36,4469,California
Contra Costa,2020-12-15,18,18,18,18,0,0,0,0,18,18,0,0,18,18,California
Contra Costa,2020-12-16,522,540,522,540,0,0,0,0,522,540,0,0,522,540,California
Contra Costa,2020-12-17,901,1441,901,1441,0,0,0,0,901,1441,0,0,901,1441,California
Contra Costa,2020-12-18,1589,3030,1588,3029,1,1,0,0,1589,3030,0,0,1589,3030,California
Contra Costa,2020-12-19,1104,4134,1103,4132,1,2,0,0,1104,4134,0,0,1104,4134,California
Contra Costa,2020-12-20,581,4715,580,4712,1,3,0,0,581,4715,0,0,581,4715,California
Contra Costa,2020-12-21,1656,6371,1654,6366,2,5,0,0,1656,6371,0,0,1656,6371,California
Contra Costa,2020-12-22,1662,8033,1555,7921,107,112,0,0,1662,8033,0,0,1662,8033,California
Contra Costa,2020-12-23,1555,9588,1311,9232,244,356,0,0,1555,9588,0,0,1555,9588,California
Contra Costa,2020-12-24,647,10235,332,9564,315,671,0,0,647,10235,0,0,647,10235,California
Contra Costa,2020-12-25,38,10273,16,9580,22,693,0,0,38,10273,0,0,38,10273,California
Contra Costa,2020-12-26,642,10915,133,9713,509,1202,0,0,642,10915,0,0,642,10915,California
Contra Costa,2020-12-27,238,11153,84,9797,154,1356,0,0,238,11153,0,0,238,11153,California
Contra Costa,2020-12-28,1813,12966,852,10649,961,2317,0,0,1813,12966,0,0,1813,12966,California
Contra Costa,2020-12-29,1825,14791,823,11472,1002,3319,0,0,1825,14791,0,0,1825,14791,California
Contra Costa,2020-12-30,2388,17179,1210,12682,1178,4497,0,0,2388,17179,0,0,2388,17179,California
Contra Costa,2020-12-31,911,18090,306,12988,605,5102,0,0,910,18089,0,0,910,18089,California
Contra Costa,2021-01-01,57,18147,23,13011,34,5136,0,0,57,18146,0,0,57,18146,California
Contra Costa,2021-01-02,332,18479,170,13181,162,5298,0,0,332,18478,0,0,332,18478,California
Contra Costa,2021-01-03,172,18651,114,13295,58,5356,0,0,171,18649,0,0,171,18649,California
Contra Costa,2021-01-04,1903,20554,1246,14541,657,6013,0,0,1883,20514,18,18,1883,20532,California
Contra Costa,2021-01-05,2091,22645,1252,15793,839,6852,0,0,1834,22093,256,274,1835,22367,California
Contra Costa,2021-01-06,3260,25905,2239,18032,1021,7873,0,0,2501,23843,753,1027,2503,24870,California
Contra Costa,2021-01-07,3073,28978,2046,20078,1027,8900,0,0,1869,24511,1201,2228,1869,26739,California
Contra Costa,2021-01-08,3351,32329,2371,22449,980,9880,0,0,1798,24765,1547,3775,1801,28540,California
Contra Costa,2021-01-09,1575,33904,1125,23574,450,10330,0,0,748,24688,826,4601,749,29289,California
Contra Costa,2021-01-10,358,34262,284,23858,74,10404,0,0,150,24630,208,4809,150,29439,California
Contra Costa,2021-01-11,3798,38060,3090,26948,708,11112,0,0,2208,25249,1590,6399,2209,31648,California
Contra Costa,2021-01-12,3882,41942,2916,29864,966,12078,0,0,2566,26499,1317,7716,2567,34215,California
Contra Costa,2021-01-13,4644,46586,2866,32730,1778,13856,0,0,3732,29323,908,8624,3732,37947,California
Contra Costa,2021-01-14,4253,50839,1542,34272,2711,16567,0,0,3867,32804,386,9010,3867,41814,California
Contra Costa,2021-01-15,5303,56142,2463,36735,2840,19407,0,0,4978,37462,324,9334,4982,46796,California
Contra Costa,2021-01-16,1703,57845,551,37286,1152,20559,0,0,1627,39013,76,9410,1627,48423,California
Contra Costa,2021-01-17,1640,59485,981,38267,659,21218,0,0,1515,40405,125,9535,1517,49940,California
Contra Costa,2021-01-18,3196,62681,1253,39520,1943,23161,0,0,2569,42355,621,10156,2571,52511,California
Contra Costa,2021-01-19,7015,69696,3143,42663,3872,27033,0,0,6018,47384,994,11150,6023,58534,California
Contra Costa,2021-01-20,6536,76232,4003,46666,2533,29566,0,0,5316,51490,1215,12365,5321,63855,California
Contra Costa,2021-01-21,6911,83143,3074,49740,3837,33403,0,0,6195,56978,711,13076,6199,70054,California
Contra Costa,2021-01-22,6326,89469,2686,52426,3640,37043,0,0,5469,61600,849,13925,5471,75525,California
Contra Costa,2021-01-23,2006,91475,354,52780,1652,38695,0,0,1755,63107,249,14174,1756,77281,California
Contra Costa,2021-01-24,1570,93045,213,52993,1357,40052,0,0,1425,64391,145,14319,1429,78710,California
Contra Costa,2021-01-25,6568,99613,2989,55982,3579,43631,0,0,5014,67857,1553,15872,5019,83729,California
Contra Costa,2021-01-26,7873,107486,4528,60510,3345,46976,0,0,6070,72134,1796,17668,6073,89802,California
Contra Costa,2021-01-27,8154,115640,5454,65964,2700,49676,0,0,6288,76648,1776,19444,6290,96092,California
Contra Costa,2021-01-28,6701,122341,3717,69681,2984,52660,0,0,5187,80329,1508,20952,5189,101281,California
Contra Costa,2021-01-29,7364,129705,3846,73527,3518,56178,0,0,6074,85118,1287,22239,6076,107357,California
Contra Costa,2021-01-30,2029,131734,553,74080,1476,57654,0,0,1710,86516,312,22551,1710,109067,California
Contra Costa,2021-01-31,745,132479,526,74606,219,57873,0,0,571,86919,168,22719,571,109638,California
Contra Costa,2021-02-01,5476,137955,3732,78338,1744,59617,0,0,3866,89184,1604,24323,3869,113507,California
Contra Costa,2021-02-02,7704,145659,5258,83596,2446,62063,0,0,5875,93233,1827,26150,5876,119383,California
Contra Costa,2021-02-03,8220,153879,5448,89044,2772,64835,0,0,5623,96267,2589,28739,5623,125006,California
Contra Costa,2021-02-04,7397,161276,3507,92551,3890,68725,0,0,5711,100298,1683,30422,5714,130720,California
Contra Costa,2021-02-05,8375,169651,4802,97353,3573,72298,0,0,5704,103336,2666,33088,5704,136424,California
Contra Costa,2021-02-06,3428,173079,2133,99486,1295,73593,0,0,2785,105480,642,33730,2786,139210,California
Contra Costa,2021-02-07,976,174055,705,100191,271,73864,0,0,606,105717,369,34099,606,139816,California
Contra Costa,2021-02-08,5708,179763,3386,103577,2322,76186,0,0,4257,108528,1447,35546,4258,144074,California
Contra Costa,2021-02-09,8388,188151,4675,108252,3713,79899,0,0,5592,111329,2791,38337,5592,149666,California
Contra Costa,2021-02-10,8519,196670,4593,112845,3926,83825,0,0,5384,113593,3125,41462,5389,155055,California
Contra Costa,2021-02-11,8320,204990,3930,116775,4390,88215,0,0,4929,115138,3385,44847,4930,159985,California
Contra Costa,2021-02-12,9523,214513,4418,121193,5105,93320,0,0,5182,115985,4337,49184,5184,165169,California
Contra Costa,2021-02-13,4765,219278,1336,122529,3429,96749,0,0,3338,117899,1424,50608,3338,168507,California
Contra Costa,2021-02-14,2054,221332,852,123381,1202,97951,0,0,1203,118252,850,51458,1203,169710,California
Contra Costa,2021-02-15,4383,225715,2429,125810,1954,99905,0,0,2315,118507,2063,53521,2318,172028,California
Contra Costa,2021-02-16,10086,235801,4731,130541,5355,105260,0,0,4533,117497,5548,59069,4538,176566,California
Contra Costa,2021-02-17,10434,246235,5355,135896,5079,110339,0,0,4669,116417,5756,64825,4676,181242,California
Contra Costa,2021-02-18,9805,256040,5273,141169,4532,114871,0,0,4869,116361,4927,69752,4871,186113,California
Contra Costa,2021-02-19,10777,266817,6743,147912,4034,118905,0,0,5085,115782,5679,75431,5100,191213,California
Contra Costa,2021-02-20,6159,272976,2848,150760,3311,122216,0,0,4497,118631,1650,77081,4499,195712,California
Contra Costa,2021-02-21,1658,274634,1151,151911,507,122723,0,0,1016,119007,642,77723,1018,196730,California
Contra Costa,2021-02-22,7074,281708,4785,156696,2289,125012,0,0,3300,118542,3768,81491,3303,200033,California
Contra Costa,2021-02-23,10934,292642,6718,163414,4216,129228,0,0,5499,118637,5423,86914,5518,205551,California
Contra Costa,2021-02-24,9403,302045,6952,170366,2451,131679,0,0,4745,118746,4644,91558,4753,210304,California
Contra Costa,2021-02-25,10534,312579,6653,177019,3881,135560,0,0,5068,118371,5448,97006,5073,215377,California
Contra Costa,2021-02-26,9435,322014,6122,183141,3313,138873,0,0,4936,118829,4485,101491,4943,220320,California
Contra Costa,2021-02-27,6414,328428,4133,187274,2281,141154,0,0,4058,120540,2350,103841,4061,224381,California
Contra Costa,2021-02-28,3662,332090,3064,190338,598,141752,0,0,3089,123060,571,104412,3091,227472,California
Contra Costa,2021-03-01,7509,339599,5666,196004,1843,143595,0,0,4725,125013,2778,107190,4731,232203,California
Contra Costa,2021-03-02,8839,348438,5628,201632,3209,146804,2,2,4759,125705,4073,111263,4765,236968,California
Contra Costa,2021-03-03,9810,358248,6160,207792,3650,150454,0,2,5274,126458,4522,115785,5275,242243,California
Contra Costa,2021-03-04,10458,368706,6092,213884,4366,154820,0,2,5192,126411,5251,121036,5204,247447,California
Contra Costa,2021-03-05,9581,378287,5622,219506,3956,158776,3,5,5242,127333,4328,125364,5250,252697,California
Contra Costa,2021-03-06,6809,385096,3888,223394,2629,161405,292,297,4409,129646,2389,127753,4702,257399,California
Contra Costa,2021-03-07,3533,388629,2227,225621,1251,162656,55,352,2879,131929,652,128405,2935,260334,California
Contra Costa,2021-03-08,7317,395946,3526,229147,3593,166249,198,550,5083,134983,2228,130633,5282,265616,California
Contra Costa,2021-03-09,9194,405140,4556,233703,4340,170589,298,848,4811,135713,4380,135013,5110,270726,California
Contra Costa,2021-03-10,10948,416088,5634,239337,4090,174679,1224,2072,5291,136580,5651,140664,6518,277244,California
Contra Costa,2021-03-11,11605,427693,6117,245454,5061,179740,427,2499,6185,137796,5407,146071,6623,283867,California
Contra Costa,2021-03-12,10947,438640,4549,250003,6094,185834,304,2803,5909,138985,5030,151101,6219,290086,California
Contra Costa,2021-03-13,6721,445361,2736,252739,3684,189518,301,3104,2783,138138,3929,155030,3082,293168,California
Contra Costa,2021-03-14,3961,449322,2377,255116,1129,190647,455,3559,1945,138526,2011,157041,2399,295567,California
Contra Costa,2021-03-15,9157,458479,4972,260088,3474,194121,711,4270,4756,139606,4390,161431,5470,301037,California
Contra Costa,2021-03-16,14052,472531,8356,268444,5308,199429,388,4658,7345,140653,6690,168121,7737,308774,California
Contra Costa,2021-03-17,13215,485746,9229,277673,3821,203250,165,4823,7884,143393,5320,173441,8060,316834,California
Contra Costa,2021-03-18,9666,495412,5677,283350,3695,206945,294,5117,5477,144992,4179,177620,5778,322612,California
Contra Costa,2021-03-19,7022,502434,4162,287512,2234,209179,626,5743,3519,145664,3500,181120,4172,326784,California
Sonoma,2020-12-15,4,4,4,4,0,0,0,0,4,4,0,0,4,4,California
Sonoma,2020-12-16,29,33,29,33,0,0,0,0,29,33,0,0,29,33,California
Sonoma,2020-12-17,101,134,101,134,0,0,0,0,101,134,0,0,101,134,California
Sonoma,2020-12-18,419,553,419,553,0,0,0,0,419,553,0,0,419,553,California
Sonoma,2020-12-19,109,662,108,661,1,1,0,0,109,662,0,0,109,662,California
Sonoma,2020-12-20,175,837,175,836,0,1,0,0,175,837,0,0,175,837,California
Sonoma,2020-12-21,910,1747,908,1744,2,3,0,0,909,1746,0,0,909,1746,California
Sonoma,2020-12-22,1363,3110,1271,3015,92,95,0,0,1363,3109,0,0,1363,3109,California
Sonoma,2020-12-23,1601,4711,1226,4241,375,470,0,0,1602,4711,0,0,1602,4711,California
Sonoma,2020-12-24,304,5015,101,4342,203,673,0,0,304,5015,0,0,304,5015,California
Sonoma,2020-12-25,8,5023,2,4344,6,679,0,0,8,5023,0,0,8,5023,California
Sonoma,2020-12-26,266,5289,255,4599,11,690,0,0,266,5289,0,0,266,5289,California
Sonoma,2020-12-27,92,5381,79,4678,13,703,0,0,92,5381,0,0,92,5381,California
Sonoma,2020-12-28,988,6369,553,5231,435,1138,0,0,960,6341,0,0,960,6341,California
Sonoma,2020-12-29,1131,7500,777,6008,354,1492,0,0,1097,7438,0,0,1097,7438,California
Sonoma,2020-12-30,1093,8593,479,6487,614,2106,0,0,1085,8523,0,0,1085,8523,California
Sonoma,2020-12-31,514,9107,70,6557,444,2550,0,0,515,9038,0,0,515,9038,California
Sonoma,2021-01-01,8,9115,4,6561,4,2554,0,0,8,9046,0,0,8,9046,California
Sonoma,2021-01-02,132,9247,125,6686,7,2561,0,0,132,9178,0,0,132,9178,California
Sonoma,2021-01-03,22,9269,8,6694,14,2575,0,0,22,9200,0,0,22,9200,California
Sonoma,2021-01-04,339,9608,103,6797,236,2811,0,0,338,9538,0,0,338,9538,California
Sonoma,2021-01-05,437,10045,102,6899,335,3146,0,0,413,9936,15,15,413,9951,California
Sonoma,2021-01-06,945,10990,432,7331,513,3659,0,0,832,10662,106,121,832,10783,California
Sonoma,2021-01-07,1008,11998,519,7850,489,4148,0,0,839,11333,168,289,839,11622,California
Sonoma,2021-01-08,1778,13776,1226,9076,552,4700,0,0,1309,12175,467,756,1309,12931,California
Sonoma,2021-01-09,654,14430,420,9496,234,4934,0,0,606,12733,48,804,606,13537,California
Sonoma,2021-01-10,467,14897,456,9952,11,4945,0,0,275,12816,192,996,275,13812,California
Sonoma,2021-01-11,1380,16277,1236,11188,144,5089,0,0,412,12264,964,1960,412,14224,California
Sonoma,2021-01-12,1547,17824,1295,12483,252,5341,0,0,394,11507,1151,3111,394,14618,California
Sonoma,2021-01-13,2058,19882,1417,13900,641,5982,0,0,1195,11842,860,3971,1195,15813,California
Sonoma,2021-01-14,1517,21399,804,14704,713,6695,0,0,1286,12897,231,4202,1286,17099,California
Sonoma,2021-01-15,1549,22948,627,15331,922,7617,0,0,1329,14016,211,4413,1330,18429,California
Sonoma,2021-01-16,1120,24068,601,15932,519,8136,0,0,872,14644,244,4657,872,19301,California
Sonoma,2021-01-17,662,24730,547,16479,115,8251,0,0,583,15148,79,4736,583,19884,California
Sonoma,2021-01-18,1095,25825,927,17406,168,8419,0,0,606,15266,489,5225,607,20491,California
Sonoma,2021-01-19,2083,27908,1004,18410,1079,9498,0,0,1377,15939,704,5929,1377,21868,California
Sonoma,2021-01-20,2050,29958,614,19024,1436,10934,0,0,1394,16687,647,6576,1395,23263,California
Sonoma,2021-01-21,2197,32155,608,19632,1589,12523,0,0,1975,18444,219,6795,1976,25239,California
Sonoma,2021-01-22,2698,34853,1027,20659,1671,14194,0,0,2550,20847,147,6942,2550,27789,California
Sonoma,2021-01-23,755,35608,589,21248,166,14360,0,0,650,21393,104,7046,650,28439,California
Sonoma,2021-01-24,761,36369,629,21877,132,14492,0,0,746,22124,15,7061,746,29185,California
Sonoma,2021-01-25,2151,38520,515,22392,1636,16128,0,0,1668,23309,483,7544,1668,30853,California
Sonoma,2021-01-26,1986,40506,293,22685,1693,17821,0,0,1534,24392,451,7995,1534,32387,California
Sonoma,2021-01-27,3576,44082,1183,23868,2393,20214,0,0,3025,26870,549,8544,3027,35414,California
Sonoma,2021-01-28,4048,48130,1811,25679,2237,22451,0,0,3420,29667,625,9169,3422,38836,California
Sonoma,2021-01-29,2917,51047,1375,27054,1542,23993,0,0,2101,30955,814,9983,2102,40938,California
Sonoma,2021-01-30,2569,53616,2386,29440,183,24176,0,0,2218,32825,351,10334,2221,43159,California
Sonoma,2021-01-31,771,54387,659,30099,112,24288,0,0,575,33205,195,10529,575,43734,California
Sonoma,2021-02-01,2461,56848,861,30960,1600,25888,0,0,2079,34906,379,10908,2080,45814,California
Sonoma,2021-02-02,3398,60246,1354,32314,2044,27932,0,0,2848,37206,548,11456,2848,48662,California
Sonoma,2021-02-03,3907,64153,1239,33553,2668,30600,0,0,3047,39395,858,12314,3047,51709,California
Sonoma,2021-02-04,4104,68257,1638,35191,2466,33066,0,0,3367,42025,737,13051,3367,55076,California
Sonoma,2021-02-05,4776,73033,1723,36914,3053,36119,0,0,3771,44796,1001,14052,3772,58848,California
Sonoma,2021-02-06,2619,75652,2257,39171,362,36481,0,0,2073,46324,545,14597,2073,60921,California
Sonoma,2021-02-07,1510,77162,1373,40544,137,36618,0,0,1276,47366,234,14831,1276,62197,California
Sonoma,2021-02-08,3181,80343,991,41535,2190,38808,0,0,2637,49461,542,15373,2637,64834,California
Sonoma,2021-02-09,3510,83853,1677,43212,1833,40641,0,0,3042,52039,466,15839,3044,67878,California
Sonoma,2021-02-10,4362,88215,2337,45549,2025,42666,0,0,3361,54404,997,16836,3362,71240,California
Sonoma,2021-02-11,5249,93464,2758,48307,2491,45157,0,0,4105,57368,1141,17977,4105,75345,California
Sonoma,2021-02-12,5500,98964,2856,51163,2644,47801,0,0,4171,60211,1328,19305,4171,79516,California
Sonoma,2021-02-13,1953,100917,1148,52311,805,48606,0,0,1191,60642,760,20065,1191,80707,California
Sonoma,2021-02-14,2273,103190,1788,54099,485,49091,0,0,1656,61682,616,20681,1656,82363,California
Sonoma,2021-02-15,2051,105241,716,54815,1335,50426,0,0,1581,62794,470,21151,1582,83945,California
Sonoma,2021-02-16,4468,109709,1945,56760,2523,52949,0,0,3246,64819,1221,22372,3246,87191,California
Sonoma,2021-02-17,5092,114801,2776,59536,2316,55265,0,0,3274,66284,1810,24182,3275,90466,California
Sonoma,2021-02-18,6511,121312,2880,62416,3631,58896,0,0,3732,67243,2774,26956,3733,94199,California
Sonoma,2021-02-19,4895,126207,1626,64042,3269,62165,0,0,3055,68463,1835,28791,3055,97254,California
Sonoma,2021-02-20,2974,129181,2736,66778,238,62403,0,0,1148,67789,1822,30613,1148,98402,California
Sonoma,2021-02-21,354,129535,258,67036,96,62499,0,0,108,67654,243,30856,108,98510,California
Sonoma,2021-02-22,2564,132099,1245,68281,1319,63818,0,0,993,67081,1567,32423,994,99504,California
Sonoma,2021-02-23,2885,134984,1927,70208,958,64776,0,0,1298,66798,1586,34009,1303,100807,California
Sonoma,2021-02-24,5045,140029,2215,72423,2830,67606,0,0,2423,66604,2618,36627,2424,103231,California
Sonoma,2021-02-25,5385,145414,2099,74522,3286,70892,0,0,2804,66849,2561,39188,2806,106037,California
Sonoma,2021-02-26,5750,151164,2655,77177,3095,73987,0,0,3551,68209,2192,41380,3552,109589,California
Sonoma,2021-02-27,3915,155079,1846,79023,2069,76056,0,0,2629,69556,1283,42663,2630,112219,California
Sonoma,2021-02-28,2160,157239,1713,80736,447,76503,0,0,563,68524,1595,44258,563,112782,California
Sonoma,2021-03-01,3502,160741,1058,81794,2444,78947,0,0,1706,68439,1792,46050,1707,114489,California
Sonoma,2021-03-02,3992,164733,1390,83184,2602,81549,0,0,2338,69132,1646,47696,2339,116828,California
Sonoma,2021-03-03,4092,168825,2212,85396,1880,83429,0,0,1748,68539,2341,50037,1748,118576,California
Sonoma,2021-03-04,4804,173629,2197,87593,2607,86036,0,0,1980,67706,2814,52851,1981,120557,California
Sonoma,2021-03-05,5027,178656,2121,89714,2891,88927,15,15,2046,66801,2972,55823,2067,122624,California
Sonoma,2021-03-06,2547,181203,1127,90841,1301,90228,119,134,1724,67823,820,56643,1842,124466,California
Sonoma,2021-03-07,1662,182865,1390,92231,241,90469,31,165,343,66879,1318,57961,374,124840,California
Sonoma,2021-03-08,3305,186170,608,92839,2565,93034,132,297,2084,67878,1218,59179,2217,127057,California
Sonoma,2021-03-09,5068,191238,2778,95617,2060,95094,230,527,2569,68182,2496,61675,2800,129857,California
Sonoma,2021-03-10,5627,196865,3010,98627,2321,97415,296,823,2298,67459,3318,64993,2595,132452,California
Sonoma,2021-03-11,7013,203878,2741,101368,3498,100913,774,1597,2493,66217,4512,69505,3270,135722,California
Sonoma,2021-03-12,6852,210730,2063,103431,3526,104439,1263,2860,1947,64536,4893,74398,3212,138934,California
Sonoma,2021-03-13,2863,213593,1411,104842,1235,105674,217,3077,1701,65293,1160,75558,1917,140851,California
Sonoma,2021-03-14,1145,214738,279,105121,727,106401,139,3216,752,65792,392,75950,891,141742,California
Sonoma,2021-03-15,5035,219773,1379,106500,3286,109687,370,3586,2195,65524,2833,78783,2565,144307,California
Sonoma,2021-03-16,6114,225887,2200,108700,3694,113381,220,3806,3237,66107,2874,81657,3457,147764,California
Sonoma,2021-03-17,5143,231030,3066,111766,1943,115324,134,3940,2848,66800,2289,83946,2982,150746,California
Sonoma,2021-03-18,3233,234263,1275,113041,1672,116996,286,4226,1411,66676,1820,85766,1696,152442,California
Sonoma,2021-03-19,2407,236670,957,113998,1390,118386,60,4286,1181,66702,1219,86985,1245,153687,California
Solano,2020-12-15,4,4,4,4,0,0,0,0,4,4,0,0,4,4,California
Solano,2020-12-16,71,75,71,75,0,0,0,0,71,75,0,0,71,75,California
Solano,2020-12-17,151,226,151,226,0,0,0,0,151,226,0,0,151,226,California
Solano,2020-12-18,449,675,448,674,1,1,0,0,449,675,0,0,449,675,California
Solano,2020-12-19,511,1186,511,1185,0,1,0,0,511,1186,0,0,511,1186,California
Solano,2020-12-20,353,1539,353,1538,0,1,0,0,353,1539,0,0,353,1539,California
Solano,2020-12-21,569,2108,568,2106,1,2,0,0,569,2108,0,0,569,2108,California
Solano,2020-12-22,662,2770,629,2735,33,35,0,0,662,2770,0,0,662,2770,California
Solano,2020-12-23,850,3620,765,3500,85,120,0,0,850,3620,0,0,850,3620,California
Solano,2020-12-24,420,4040,169,3669,251,371,0,0,420,4040,0,0,420,4040,California
Solano,2020-12-25,10,4050,2,3671,8,379,0,0,10,4050,0,0,10,4050,California
Solano,2020-12-26,174,4224,48,3719,126,505,0,0,174,4224,0,0,174,4224,California
Solano,2020-12-27,101,4325,28,3747,73,578,0,0,101,4325,0,0,101,4325,California
Solano,2020-12-28,855,5180,416,4163,439,1017,0,0,855,5180,0,0,855,5180,California
Solano,2020-12-29,882,6062,373,4536,509,1526,0,0,882,6062,0,0,882,6062,California
Solano,2020-12-30,1194,7256,594,5130,600,2126,0,0,1194,7256,0,0,1194,7256,California
Solano,2020-12-31,530,7786,130,5260,400,2526,0,0,530,7786,0,0,530,7786,California
Solano,2021-01-01,14,7800,12,5272,2,2528,0,0,14,7800,0,0,14,7800,California
Solano,2021-01-02,211,8011,163,5435,48,2576,0,0,211,8011,0,0,211,8011,California
Solano,2021-01-03,56,8067,39,5474,17,2593,0,0,51,8062,0,0,51,8062,California
Solano,2021-01-04,449,8516,246,5720,203,2796,0,0,439,8498,3,3,439,8501,California
Solano,2021-01-05,692,9208,376,6096,316,3112,0,0,538,8887,149,152,538,9039,California
Solano,2021-01-06,814,10022,434,6530,380,3492,0,0,553,9181,259,411,553,9592,California
Solano,2021-01-07,1043,11065,694,7224,349,3841,0,0,589,9319,452,863,590,10182,California
Solano,2021-01-08,1124,12189,775,7999,349,4190,0,0,532,9278,574,1437,533,10715,California
Solano,2021-01-09,882,13071,760,8759,122,4312,0,0,428,9255,451,1888,428,11143,California
Solano,2021-01-10,250,13321,191,8950,59,4371,0,0,150,9305,100,1988,150,11293,California
Solano,2021-01-11,1316,14637,1105,10055,211,4582,0,0,802,9594,514,2502,803,12096,California
Solano,2021-01-12,1531,16168,1156,11211,375,4957,0,0,985,10036,545,3047,987,13083,California
Solano,2021-01-13,1399,17567,993,12204,406,5363,0,0,1147,10933,250,3297,1147,14230,California
Solano,2021-01-14,1710,19277,788,12992,922,6285,0,0,1396,12016,313,3610,1396,15626,California
Solano,2021-01-15,1648,20925,1057,14049,591,6876,0,0,1354,13076,294,3904,1354,16980,California
Solano,2021-01-16,1254,22179,906,14955,348,7224,0,0,1075,13972,179,4083,1075,18055,California
Solano,2021-01-17,986,23165,745,15700,241,7465,0,0,969,14924,17,4100,969,19024,California
Solano,2021-01-18,1406,24571,859,16559,547,8012,0,0,1293,16105,113,4213,1294,20318,California
Solano,2021-01-19,1621,26192,1330,17889,291,8303,0,0,1351,17187,269,4482,1351,21669,California
Solano,2021-01-20,1936,28128,1412,19301,524,8827,0,0,1457,18168,476,4958,1457,23126,California
Solano,2021-01-21,2310,30438,986,20287,1324,10151,0,0,1976,19811,333,5291,1976,25102,California
Solano,2021-01-22,1611,32049,834,21121,777,10928,0,0,1422,21044,189,5480,1422,26524,California
Solano,2021-01-23,727,32776,236,21357,491,11419,0,0,524,21365,204,5684,525,27049,California
Solano,2021-01-24,372,33148,59,21416,313,11732,0,0,308,21609,64,5748,308,27357,California
Solano,2021-01-25,1570,34718,621,22037,949,12681,0,0,1025,22090,545,6293,1026,28383,California
Solano,2021-01-26,1655,36373,733,22770,922,13603,0,0,1031,22499,623,6916,1032,29415,California
Solano,2021-01-27,1743,38116,726,23496,1017,14620,0,0,1170,23109,560,7476,1170,30585,California
Solano,2021-01-28,1806,39922,709,24205,1097,15717,0,0,1217,23739,588,8064,1218,31803,California
Solano,2021-01-29,1622,41544,779,24984,843,16560,0,0,1267,24656,353,8417,1270,33073,California
Solano,2021-01-30,706,42250,218,25202,488,17048,0,0,552,25054,154,8571,552,33625,California
Solano,2021-01-31,476,42726,397,25599,79,17127,0,0,215,25008,261,8832,215,33840,California
Solano,2021-02-01,1456,44182,961,26560,495,17622,0,0,732,25019,721,9553,732,34572,California
Solano,2021-02-02,2496,46678,1030,27590,1466,19088,0,0,1722,25969,772,10325,1722,36294,California
Solano,2021-02-03,2184,48862,1285,28875,899,19987,0,0,1132,26056,1049,11374,1136,37430,California
Solano,2021-02-04,1734,50596,898,29773,836,20823,0,0,1032,26392,696,12070,1032,38462,California
Solano,2021-02-05,3019,53615,1402,31175,1617,22440,0,0,2031,27447,982,13052,2037,40499,California
Solano,2021-02-06,2925,56540,1158,32333,1767,24207,0,0,2123,28771,799,13851,2123,42622,California
Solano,2021-02-07,846,57386,787,33120,59,24266,0,0,233,28391,613,14464,233,42855,California
Solano,2021-02-08,1669,59055,1216,34336,453,24719,0,0,644,28010,1025,15489,644,43499,California
Solano,2021-02-09,1856,60911,1455,35791,401,25120,0,0,651,27457,1204,16693,651,44150,California
Solano,2021-02-10,2212,63123,1484,37275,728,25848,0,0,815,26875,1397,18090,815,44965,California
Solano,2021-02-11,2269,65392,1400,38675,869,26717,0,0,1092,26803,1164,19254,1092,46057,California
Solano,2021-02-12,3913,69305,1527,40202,2386,29103,0,0,2634,28164,1275,20529,2636,48693,California
Solano,2021-02-13,2752,72057,230,40432,2522,31625,0,0,2387,30189,362,20891,2387,51080,California
Solano,2021-02-14,673,72730,197,40629,476,32101,0,0,400,30318,271,21162,400,51480,California
Solano,2021-02-15,1187,73917,240,40869,947,33048,0,0,608,30347,579,21741,608,52088,California
Solano,2021-02-16,2209,76126,1173,42042,1036,34084,0,0,1482,31104,726,22467,1483,53571,California
Solano,2021-02-17,2280,78406,1176,43218,1104,35188,0,0,1522,31876,756,23223,1528,55099,California
Solano,2021-02-18,1703,80109,648,43866,1055,36243,0,0,654,31488,1042,24265,654,55753,California
Solano,2021-02-19,1807,81916,1184,45050,623,36866,0,0,898,31483,906,25171,901,56654,California
Solano,2021-02-20,2361,84277,357,45407,2004,38870,0,0,1927,32976,434,25605,1927,58581,California
Solano,2021-02-21,1909,86186,1660,47067,249,39119,0,0,1657,34383,250,25855,1657,60238,California
Solano,2021-02-22,1460,87646,878,47945,582,39701,0,0,765,34454,694,26549,765,61003,California
Solano,2021-02-23,1898,89544,953,48898,945,40646,0,0,1102,34762,795,27344,1103,62106,California
Solano,2021-02-24,2199,91743,1077,49975,1122,41768,0,0,1233,35031,965,28309,1234,63340,California
Solano,2021-02-25,2109,93852,1276,51251,833,42601,0,0,1139,35206,964,29273,1139,64479,California
Solano,2021-02-26,2266,96118,1256,52507,1010,43611,0,0,1115,35173,1148,30421,1115,65594,California
Solano,2021-02-27,3521,99639,1341,53848,2180,45791,0,0,2856,37372,660,31081,2859,68453,California
Solano,2021-02-28,1306,100945,1013,54861,293,46084,0,0,1052,38172,252,31333,1052,69505,California
Solano,2021-03-01,1672,102617,985,55846,687,46771,0,0,1105,38714,564,31897,1106,70611,California
Solano,2021-03-02,1674,104291,1147,56993,527,47298,0,0,1137,39314,537,32434,1137,71748,California
Solano,2021-03-03,1665,105956,912,57905,753,48051,0,0,974,39605,685,33119,976,72724,California
Solano,2021-03-04,2621,108577,1813,59718,807,48858,1,1,1889,40769,729,33848,1893,74617,California
Solano,2021-03-05,3455,112032,1100,60818,2353,51211,2,3,2745,42808,710,34558,2749,77366,California
Solano,2021-03-06,3434,115466,691,61509,2703,53914,40,43,2360,44139,1069,35627,2400,79766,California
Solano,2021-03-07,3241,118707,723,62232,2506,56420,12,55,1853,44625,1379,37006,1865,81631,California
Solano,2021-03-08,1402,120109,765,62997,378,56798,259,314,982,45447,419,37425,1241,82872,California
Solano,2021-03-09,1910,122019,1288,64285,569,57367,53,367,1140,45868,770,38195,1191,84063,California
Solano,2021-03-10,2086,124105,1509,65794,489,57856,88,455,1058,45987,1027,39222,1146,85209,California
Solano,2021-03-11,4294,128399,1361,67155,2741,60597,192,647,3478,48845,814,40036,3672,88881,California
Solano,2021-03-12,4828,133227,1301,68456,3463,64060,64,711,2707,49502,2117,42153,2774,91655,California
Solano,2021-03-13,2682,135909,751,69207,1859,65919,72,783,1443,49784,1237,43390,1519,93174,California
Solano,2021-03-14,2912,138821,2155,71362,312,66231,445,1228,1274,49870,1635,45025,1721,94895,California
Solano,2021-03-15,2517,141338,1071,72433,1132,67363,314,1542,1216,50101,1299,46324,1530,96425,California
Solano,2021-03-16,2681,144019,1115,73548,1337,68700,229,1771,1371,50392,1308,47632,1599,98024,California
Solano,2021-03-17,3455,147474,1253,74801,2137,70837,65,1836,2499,52005,952,48584,2565,100589,California
Solano,2021-03-18,1955,149429,945,75746,992,71829,18,1854,1338,52749,612,49196,1356,101945,California
Solano,2021-03-19,884,150313,643,76389,215,72044,26,1880,508,52911,375,49571,537,102482,California
Trinity,2020-12-17,4,4,4,4,0,0,0,0,4,4,0,0,4,4,California
Trinity,2020-12-18,2,6,2,6,0,0,0,0,2,6,0,0,2,6,California
Trinity,2020-12-21,37,43,37,43,0,0,0,0,37,43,0,0,37,43,California
Trinity,2020-12-22,5,48,5,48,0,0,0,0,5,48,0,0,5,48,California
Trinity,2020-12-23,5,53,5,53,0,0,0,0,5,53,0,0,5,53,California
Trinity,2020-12-28,30,83,30,83,0,0,0,0,30,83,0,0,30,83,California
Trinity,2020-12-29,8,91,7,90,1,1,0,0,8,91,0,0,8,91,California
Trinity,2020-12-30,10,101,8,98,2,3,0,0,10,101,0,0,10,101,California
Trinity,2020-12-31,2,103,1,99,1,4,0,0,2,103,0,0,2,103,California
Trinity,2021-01-04,27,130,1,100,26,30,0,0,26,129,0,0,26,129,California
Trinity,2021-01-05,2,132,1,101,1,31,0,0,2,131,0,0,2,131,California
Trinity,2021-01-06,23,155,4,105,19,50,0,0,19,146,4,4,19,150,California
Trinity,2021-01-08,49,204,2,107,47,97,0,0,47,191,2,6,47,197,California
Trinity,2021-01-11,40,244,39,146,1,98,0,0,2,155,38,44,2,199,California
Trinity,2021-01-12,8,252,6,152,2,100,0,0,3,153,5,49,3,202,California
Trinity,2021-01-13,7,259,4,156,3,103,0,0,4,154,3,52,4,206,California
Trinity,2021-01-14,3,262,1,157,2,105,0,0,3,157,0,52,3,209,California
Trinity,2021-01-16,4,266,0,157,4,109,0,0,4,161,0,52,4,213,California
Trinity,2021-01-18,31,297,31,188,0,109,0,0,1,132,30,82,1,214,California
Trinity,2021-01-19,31,328,14,202,17,126,0,0,17,135,14,96,17,231,California
Trinity,2021-01-20,18,346,2,204,16,142,0,0,16,149,2,98,16,247,California
Trinity,2021-01-21,14,360,6,210,8,150,0,0,14,163,0,98,14,261,California
Trinity,2021-01-22,4,364,0,210,4,154,0,0,4,167,0,98,4,265,California
Trinity,2021-01-23,3,367,2,212,1,155,0,0,3,170,0,98,3,268,California
Trinity,2021-01-25,14,381,1,213,13,168,0,0,13,182,1,99,13,281,California
Trinity,2021-01-26,10,391,1,214,9,177,0,0,9,190,1,100,9,290,California
Trinity,2021-01-27,12,403,0,214,12,189,0,0,12,202,0,100,12,302,California
Trinity,2021-01-28,13,416,3,217,10,199,0,0,10,209,3,103,10,312,California
Trinity,2021-01-29,3,419,1,218,2,201,0,0,2,210,1,104,2,314,California
Trinity,2021-01-30,13,432,11,229,2,203,0,0,13,223,0,104,13,327,California
Trinity,2021-01-31,1,433,1,230,0,203,0,0,1,224,0,104,1,328,California
Trinity,2021-02-01,2,435,1,231,1,204,0,0,1,224,1,105,1,329,California
Trinity,2021-02-02,10,445,0,231,10,214,0,0,10,234,0,105,10,339,California
Trinity,2021-02-03,6,451,1,232,5,219,0,0,3,234,3,108,3,342,California
Trinity,2021-02-04,33,484,29,261,4,223,0,0,31,263,2,110,31,373,California
Trinity,2021-02-05,348,832,0,261,348,571,0,0,318,551,30,140,318,691,California
Trinity,2021-02-06,208,1040,3,264,205,776,0,0,201,745,7,147,201,892,California
Trinity,2021-02-08,23,1063,0,264,23,799,0,0,15,752,8,155,15,907,California
Trinity,2021-02-09,19,1082,0,264,19,818,0,0,4,741,15,170,4,911,California
Trinity,2021-02-10,113,1195,0,264,113,931,0,0,98,824,15,185,98,1009,California
Trinity,2021-02-11,260,1455,2,266,258,1189,0,0,254,1072,6,191,254,1263,California
Trinity,2021-02-12,9,1464,6,272,3,1192,0,0,9,1081,0,191,9,1272,California
Trinity,2021-02-13,11,1475,4,276,7,1199,0,0,5,1080,6,197,5,1277,California
Trinity,2021-02-14,2,1477,2,278,0,1199,0,0,2,1082,0,197,2,1279,California
Trinity,2021-02-15,47,1524,0,278,47,1246,0,0,47,1129,0,197,47,1326,California
Trinity,2021-02-16,6,1530,1,279,5,1251,0,0,3,1130,3,200,4,1330,California
Trinity,2021-02-17,93,1623,2,281,91,1342,0,0,84,1205,9,209,84,1414,California
Trinity,2021-02-18,3,1626,0,281,3,1345,0,0,1,1204,2,211,1,1415,California
Trinity,2021-02-19,209,1835,2,283,207,1552,0,0,196,1387,13,224,196,1611,California
Trinity,2021-02-20,138,1973,13,296,125,1677,0,0,114,1477,24,248,114,1725,California
Trinity,2021-02-21,1,1974,1,297,0,1677,0,0,0,1476,1,249,0,1725,California
Trinity,2021-02-22,3,1977,0,297,3,1680,0,0,0,1473,3,252,0,1725,California
Trinity,2021-02-23,5,1982,1,298,4,1684,0,0,2,1472,3,255,2,1727,California
Trinity,2021-02-24,21,2003,2,300,19,1703,0,0,3,1457,18,273,3,1730,California
Trinity,2021-02-25,36,2039,23,323,13,1716,0,0,6,1433,30,303,6,1736,California
Trinity,2021-02-26,10,2049,1,324,9,1725,0,0,5,1433,5,308,5,1741,California
Trinity,2021-02-27,6,2055,3,327,3,1728,0,0,3,1433,3,311,3,1744,California
Trinity,2021-02-28,1,2056,1,328,0,1728,0,0,1,1434,0,311,1,1745,California
Trinity,2021-03-01,7,2063,0,328,7,1735,0,0,5,1437,2,313,5,1750,California
Trinity,2021-03-02,6,2069,1,329,5,1740,0,0,1,1433,5,318,1,1751,California
Trinity,2021-03-03,5,2074,0,329,5,1745,0,0,4,1436,1,319,4,1755,California
Trinity,2021-03-04,15,2089,10,339,5,1750,0,0,13,1447,2,321,13,1768,California
Trinity,2021-03-05,282,2371,1,340,280,2030,1,1,33,1234,247,568,34,1802,California
Trinity,2021-03-06,186,2557,7,347,179,2209,0,1,21,1090,165,733,21,1823,California
Trinity,2021-03-07,3,2560,3,350,0,2209,0,1,2,1091,1,734,2,1825,California
Trinity,2021-03-08,3,2563,0,350,2,2211,1,2,1,1091,2,736,2,1827,California
Trinity,2021-03-09,94,2657,1,351,91,2302,2,4,90,1179,4,740,92,1919,California
Trinity,2021-03-10,127,2784,5,356,121,2423,1,5,40,1133,87,827,41,1960,California
Trinity,2021-03-11,12,2796,4,360,5,2428,3,8,7,1138,5,832,10,1970,California
Trinity,2021-03-12,324,3120,3,363,316,2744,5,13,93,1005,231,1063,98,2068,California
Trinity,2021-03-13,10,3130,7,370,2,2746,1,14,7,1010,3,1066,8,2076,California
Trinity,2021-03-15,68,3198,0,370,66,2812,2,16,14,972,54,1120,16,2092,California
Trinity,2021-03-16,113,3311,8,378,105,2917,0,16,101,1061,12,1132,101,2193,California
Trinity,2021-03-17,99,3410,2,380,97,3014,0,16,25,1012,74,1206,25,2218,California
Trinity,2021-03-18,3,3413,3,383,0,3014,0,16,2,1013,1,1207,2,2220,California
Trinity,2021-03-19,326,3739,0,383,230,3244,96,112,23,829,303,1510,119,2339,California
Santa Barbara,2020-12-15,2,2,2,2,0,0,0,0,2,2,0,0,2,2,California
Santa Barbara,2020-12-16,2,4,2,4,0,0,0,0,2,4,0,0,2,4,California
Santa Barbara,2020-12-17,51,55,51,55,0,0,0,0,51,55,0,0,51,55,California
Santa Barbara,2020-12-18,377,432,376,431,1,1,0,0,377,432,0,0,377,432,California
Santa Barbara,2020-12-19,325,757,325,756,0,1,0,0,325,757,0,0,325,757,California
Santa Barbara,2020-12-20,234,991,234,990,0,1,0,0,234,991,0,0,234,991,California
Santa Barbara,2020-12-21,649,1640,647,1637,2,3,0,0,649,1640,0,0,649,1640,California
Santa Barbara,2020-12-22,243,1883,241,1878,2,5,0,0,243,1883,0,0,243,1883,California
Santa Barbara,2020-12-23,320,2203,202,2080,118,123,0,0,320,2203,0,0,320,2203,California
Santa Barbara,2020-12-24,87,2290,40,2120,47,170,0,0,87,2290,0,0,87,2290,California
Santa Barbara,2020-12-26,328,2618,67,2187,261,431,0,0,328,2618,0,0,328,2618,California
Santa Barbara,2020-12-27,62,2680,1,2188,61,492,0,0,62,2680,0,0,62,2680,California
Santa Barbara,2020-12-28,352,3032,218,2406,134,626,0,0,352,3032,0,0,352,3032,California
Santa Barbara,2020-12-29,550,3582,358,2764,192,818,0,0,550,3582,0,0,550,3582,California
Santa Barbara,2020-12-30,580,4162,401,3165,179,997,0,0,580,4162,0,0,580,4162,California
Santa Barbara,2020-12-31,238,4400,112,3277,126,1123,0,0,238,4400,0,0,238,4400,California
Santa Barbara,2021-01-01,107,4507,106,3383,1,1124,0,0,107,4507,0,0,107,4507,California
Santa Barbara,2021-01-02,587,5094,224,3607,363,1487,0,0,587,5094,0,0,587,5094,California
Santa Barbara,2021-01-03,23,5117,15,3622,8,1495,0,0,23,5117,0,0,23,5117,California
Santa Barbara,2021-01-04,303,5420,242,3864,61,1556,0,0,302,5419,0,0,302,5419,California
Santa Barbara,2021-01-05,748,6168,376,4240,372,1928,0,0,722,6115,26,26,722,6141,California
Santa Barbara,2021-01-06,656,6824,273,4513,383,2311,0,0,598,6656,57,83,598,6739,California
Santa Barbara,2021-01-07,1026,7850,704,5217,322,2633,0,0,522,6678,500,583,522,7261,California
Santa Barbara,2021-01-08,1201,9051,839,6056,362,2995,0,0,708,6893,493,1076,708,7969,California
Santa Barbara,2021-01-09,567,9618,292,6348,275,3270,0,0,322,6970,245,1321,322,8291,California
Santa Barbara,2021-01-10,63,9681,51,6399,12,3282,0,0,47,7001,16,1337,47,8338,California
Santa Barbara,2021-01-11,839,10520,668,7067,171,3453,0,0,615,7393,223,1560,615,8953,California
Santa Barbara,2021-01-12,1426,11946,632,7699,794,4247,0,0,1269,8505,157,1717,1269,10222,California
Santa Barbara,2021-01-13,1228,13174,280,7979,948,5195,0,0,1103,9483,125,1842,1103,11325,California
Santa Barbara,2021-01-14,1239,14413,132,8111,1107,6302,0,0,1185,10615,53,1895,1185,12510,California
Santa Barbara,2021-01-15,1790,16203,413,8524,1377,7679,0,0,1711,12248,78,1973,1711,14221,California
Santa Barbara,2021-01-16,1267,17470,199,8723,1068,8747,0,0,1229,13440,37,2010,1229,15450,California
Santa Barbara,2021-01-17,124,17594,21,8744,103,8850,0,0,121,13558,3,2013,121,15571,California
Santa Barbara,2021-01-18,1150,18744,416,9160,734,9584,0,0,966,14341,183,2196,966,16537,California
Santa Barbara,2021-01-19,1631,20375,565,9725,1066,10650,0,0,1353,15417,277,2473,1353,17890,California
Santa Barbara,2021-01-20,1979,22354,441,10166,1538,12188,0,0,1690,16819,288,2761,1690,19580,California
Santa Barbara,2021-01-21,3079,25433,1809,11975,1270,13458,0,0,2928,19597,151,2912,2929,22509,California
Santa Barbara,2021-01-22,2991,28424,1848,13823,1143,14601,0,0,2846,22301,142,3054,2846,25355,California
Santa Barbara,2021-01-23,1732,30156,1107,14930,625,15226,0,0,1222,23014,509,3563,1222,26577,California
Santa Barbara,2021-01-24,845,31001,754,15684,91,15317,0,0,837,23843,8,3571,837,27414,California
Santa Barbara,2021-01-25,1232,32233,492,16176,740,16057,0,0,996,24603,236,3807,996,28410,California
Santa Barbara,2021-01-26,2034,34267,459,16635,1575,17632,0,0,1650,25872,382,4189,1651,30061,California
Santa Barbara,2021-01-27,1154,35421,400,17035,754,18386,0,0,901,26521,252,4441,901,30962,California
Santa Barbara,2021-01-28,880,36301,284,17319,596,18982,0,0,670,26984,207,4648,670,31632,California
Santa Barbara,2021-01-29,1323,37624,529,17848,794,19776,0,0,971,27607,350,4998,973,32605,California
Santa Barbara,2021-01-30,1894,39518,1421,19269,473,20249,0,0,1493,28702,398,5396,1493,34098,California
Santa Barbara,2021-01-31,1460,40978,1221,20490,239,20488,0,0,1420,30082,40,5436,1420,35518,California
Santa Barbara,2021-02-01,931,41909,516,21006,415,20903,0,0,545,30242,385,5821,545,36063,California
Santa Barbara,2021-02-02,1806,43715,692,21698,1114,22017,0,0,1034,30507,769,6590,1034,37097,California
Santa Barbara,2021-02-03,1946,45661,1077,22775,869,22886,0,0,1502,31575,434,7024,1502,38599,California
Santa Barbara,2021-02-04,2775,48436,1857,24632,918,23804,0,0,2482,33769,288,7312,2482,41081,California
Santa Barbara,2021-02-05,2901,51337,2056,26688,845,24649,0,0,2260,35389,640,7952,2260,43341,California
Santa Barbara,2021-02-06,1194,52531,336,27024,858,25507,0,0,792,35779,402,8354,792,44133,California
Santa Barbara,2021-02-07,299,52830,261,27285,38,25545,0,0,265,36010,34,8388,265,44398,California
Santa Barbara,2021-02-08,949,53779,304,27589,645,26190,0,0,666,36393,283,8671,666,45064,California
Santa Barbara,2021-02-09,2424,56203,309,27898,2115,28305,0,0,1115,36207,1301,9972,1115,46179,California
Santa Barbara,2021-02-10,2750,58953,1492,29390,1258,29563,0,0,797,35058,1947,11919,798,46977,California
Santa Barbara,2021-02-11,4164,63117,2795,32185,1369,30932,0,0,617,32133,3542,15461,617,47594,California
Santa Barbara,2021-02-12,3278,66395,944,33129,2334,33266,0,0,764,30388,2509,17970,764,48358,California
Santa Barbara,2021-02-13,1220,67615,329,33458,891,34157,0,0,551,30273,666,18636,551,48909,California
Santa Barbara,2021-02-14,328,67943,33,33491,295,34452,0,0,282,30509,46,18682,282,49191,California
Santa Barbara,2021-02-15,944,68887,333,33824,611,35063,0,0,479,30527,461,19143,479,49670,California
Santa Barbara,2021-02-16,2082,70969,388,34212,1694,36757,0,0,699,29845,1381,20524,699,50369,California
Santa Barbara,2021-02-17,1420,72389,315,34527,1105,37862,0,0,510,29447,908,21432,510,50879,California
Santa Barbara,2021-02-18,3228,75617,2643,37170,585,38447,0,0,1513,29280,1680,23112,1513,52392,California
Santa Barbara,2021-02-19,3600,79217,2650,39820,950,39397,0,0,2339,30360,1259,24371,2339,54731,California
Santa Barbara,2021-02-20,2152,81369,1390,41210,762,40159,0,0,1634,31483,511,24882,1634,56365,California
Santa Barbara,2021-02-21,76,81445,52,41262,24,40183,0,0,44,31497,31,24913,45,56410,California
Santa Barbara,2021-02-22,888,82333,231,41493,657,40840,0,0,249,31113,633,25546,249,56659,California
Santa Barbara,2021-02-23,3148,85481,1044,42537,2104,42944,0,0,407,28781,2739,28285,407,57066,California
Santa Barbara,2021-02-24,3096,88577,1061,43598,2035,44979,0,0,681,27054,2408,30693,681,57747,California
Santa Barbara,2021-02-25,3378,91955,1878,45476,1500,46479,0,0,948,25579,2423,33116,948,58695,California
Santa Barbara,2021-02-26,3272,95227,2147,47623,1125,47604,0,0,1798,25908,1470,34586,1799,60494,California
Santa Barbara,2021-02-27,1468,96695,560,48183,908,48512,0,0,814,26073,650,35236,815,61309,California
Santa Barbara,2021-02-28,999,97694,199,48382,800,49312,0,0,823,26722,175,35411,824,62133,California
Santa Barbara,2021-03-01,1519,99213,451,48833,1068,50380,0,0,1041,27287,476,35887,1041,63174,California
Santa Barbara,2021-03-02,2388,101601,376,49209,2012,52392,0,0,1941,28791,437,36324,1941,65115,California
Santa Barbara,2021-03-03,4410,106011,2057,51266,2352,54744,1,1,3858,32111,542,36866,3862,68977,California
Santa Barbara,2021-03-04,3098,109109,2034,53300,1064,55808,0,1,2580,34177,515,37381,2581,71558,California
Santa Barbara,2021-03-05,3714,112823,2130,55430,1528,57336,56,57,3022,36568,688,38069,3079,74637,California
Santa Barbara,2021-03-06,2318,115141,659,56089,1460,58796,199,256,1581,37612,735,38804,1779,76416,California
Santa Barbara,2021-03-07,541,115682,123,56212,302,59098,116,372,379,37945,162,38966,495,76911,California
Santa Barbara,2021-03-08,1147,116829,289,56501,602,59700,256,628,547,38150,598,39564,803,77714,California
Santa Barbara,2021-03-09,2655,119484,323,56824,1629,61329,703,1331,680,37561,1972,41536,1383,79097,California
Santa Barbara,2021-03-10,2422,121906,419,57243,1100,62429,903,2234,860,37768,1556,43092,1763,80860,California
Santa Barbara,2021-03-11,5276,127182,2934,60177,1326,63755,1016,3250,2134,37785,3136,46228,3153,84013,California
Santa Barbara,2021-03-12,2921,130103,1787,61964,809,64564,325,3575,1806,38804,1113,47341,2132,86145,California
Santa Barbara,2021-03-13,2659,132762,1487,63451,1038,65602,134,3709,2150,40582,507,47848,2285,88430,California
Santa Barbara,2021-03-14,484,133246,237,63688,195,65797,52,3761,285,40720,199,48047,337,88767,California
Santa Barbara,2021-03-15,2013,135259,669,64357,1083,66880,261,4022,1214,41401,795,48842,1476,90243,California
Santa Barbara,2021-03-16,3470,138729,1126,65483,2036,68916,308,4330,2545,43330,923,49765,2852,93095,California
Santa Barbara,2021-03-17,2424,141153,702,66185,1488,70404,234,4564,1743,44628,679,50444,1977,95072,California
Santa Barbara,2021-03-18,2370,143523,1542,67727,708,71112,120,4684,1650,45682,717,51161,1771,96843,California
Santa Barbara,2021-03-19,1393,144916,980,68707,402,71514,11,4695,928,46157,465,51626,940,97783,California
Amador,2020-12-16,2,2,2,2,0,0,0,0,2,2,0,0,2,2,California
Amador,2020-12-17,5,7,5,7,0,0,0,0,5,7,0,0,5,7,California
Amador,2020-12-18,44,51,44,51,0,0,0,0,44,51,0,0,44,51,California
Amador,2020-12-19,17,68,17,68,0,0,0,0,17,68,0,0,17,68,California
Amador,2020-12-20,4,72,4,72,0,0,0,0,4,72,0,0,4,72,California
Amador,2020-12-21,33,105,33,105,0,0,0,0,33,105,0,0,33,105,California
Amador,2020-12-22,36,141,35,140,1,1,0,0,36,141,0,0,36,141,California
Amador,2020-12-23,39,180,38,178,1,2,0,0,39,180,0,0,39,180,California
Amador,2020-12-24,5,185,3,181,2,4,0,0,5,185,0,0,5,185,California
Amador,2020-12-26,6,191,5,186,1,5,0,0,6,191,0,0,6,191,California
Amador,2020-12-27,1,192,0,186,1,6,0,0,1,192,0,0,1,192,California
Amador,2020-12-28,31,223,27,213,4,10,0,0,31,223,0,0,31,223,California
Amador,2020-12-29,26,249,19,232,7,17,0,0,26,249,0,0,26,249,California
Amador,2020-12-30,120,369,75,307,45,62,0,0,120,369,0,0,120,369,California
Amador,2020-12-31,192,561,167,474,25,87,0,0,192,561,0,0,192,561,California
Amador,2021-01-01,1,562,0,474,1,88,0,0,1,562,0,0,1,562,California
Amador,2021-01-02,55,617,55,529,0,88,0,0,55,617,0,0,55,617,California
Amador,2021-01-03,64,681,16,545,48,136,0,0,64,681,0,0,64,681,California
Amador,2021-01-04,124,805,1,546,123,259,0,0,123,803,1,1,123,804,California
Amador,2021-01-05,33,838,3,549,30,289,0,0,32,834,1,2,32,836,California
Amador,2021-01-06,38,876,10,559,28,317,0,0,34,864,4,6,34,870,California
Amador,2021-01-07,223,1099,66,625,157,474,0,0,211,1063,12,18,211,1081,California
Amador,2021-01-08,84,1183,70,695,14,488,0,0,40,1059,44,62,40,1121,California
Amador,2021-01-09,11,1194,11,706,0,488,0,0,2,1052,9,71,2,1123,California
Amador,2021-01-10,7,1201,5,711,2,490,0,0,3,1051,4,75,3,1126,California
Amador,2021-01-11,124,1325,44,755,80,570,0,0,88,1103,36,111,88,1214,California
Amador,2021-01-12,62,1387,48,803,14,584,0,0,32,1113,30,141,40,1254,California
Amador,2021-01-13,39,1426,25,828,14,598,0,0,26,1126,13,154,26,1280,California
Amador,2021-01-14,146,1572,20,848,126,724,0,0,136,1252,10,164,136,1416,California
Amador,2021-01-15,56,1628,22,870,34,758,0,0,48,1292,8,172,48,1464,California
Amador,2021-01-16,18,1646,12,882,6,764,0,0,12,1298,6,178,12,1476,California
Amador,2021-01-17,22,1668,5,887,17,781,0,0,22,1320,0,178,22,1498,California
Amador,2021-01-18,31,1699,26,913,5,786,0,0,9,1307,22,200,9,1507,California
Amador,2021-01-19,120,1819,96,1009,24,810,0,0,71,1334,49,249,76,1583,California
Amador,2021-01-20,182,2001,32,1041,150,960,0,0,167,1487,14,263,167,1750,California
Amador,2021-01-21,251,2252,220,1261,31,991,0,0,132,1510,119,382,142,1892,California
Amador,2021-01-22,133,2385,70,1331,63,1054,0,0,127,1631,6,388,127,2019,California
Amador,2021-01-23,51,2436,32,1363,19,1073,0,0,49,1678,2,390,49,2068,California
Amador,2021-01-24,27,2463,11,1374,16,1089,0,0,24,1699,3,393,24,2092,California
Amador,2021-01-25,54,2517,26,1400,28,1117,0,0,38,1721,16,409,38,2130,California
Amador,2021-01-26,239,2756,16,1416,223,1340,0,0,229,1940,10,419,229,2359,California
Amador,2021-01-27,295,3051,29,1445,266,1606,0,0,250,2147,43,462,250,2609,California
Amador,2021-01-28,339,3390,69,1514,270,1876,0,0,279,2368,60,522,281,2890,California
Amador,2021-01-29,94,3484,30,1544,64,1940,0,0,79,2432,15,537,79,2969,California
Amador,2021-01-30,165,3649,30,1574,135,2075,0,0,160,2587,5,542,160,3129,California
Amador,2021-01-31,32,3681,28,1602,4,2079,0,0,31,2617,1,543,31,3160,California
Amador,2021-02-01,61,3742,22,1624,39,2118,0,0,34,2624,27,570,34,3194,California
Amador,2021-02-02,215,3957,64,1688,151,2269,0,0,118,2656,94,664,126,3320,California
Amador,2021-02-03,140,4097,37,1725,103,2372,0,0,88,2695,51,715,90,3410,California
Amador,2021-02-04,245,4342,68,1793,177,2549,0,0,159,2772,86,801,163,3573,California
Amador,2021-02-05,317,4659,59,1852,258,2807,0,0,305,3065,12,813,305,3878,California
Amador,2021-02-06,100,4759,81,1933,19,2826,0,0,96,3157,4,817,96,3974,California
Amador,2021-02-07,37,4796,35,1968,2,2828,0,0,34,3188,3,820,34,4008,California
Amador,2021-02-08,90,4886,62,2030,28,2856,0,0,73,3244,17,837,73,4081,California
Amador,2021-02-09,168,5054,81,2111,87,2943,0,0,105,3288,63,900,107,4188,California
Amador,2021-02-10,709,5763,77,2188,632,3575,0,0,676,3931,33,933,676,4864,California
Amador,2021-02-11,302,6065,118,2306,184,3759,0,0,197,4025,104,1037,198,5062,California
Amador,2021-02-12,321,6386,117,2423,204,3963,0,0,247,4200,74,1111,249,5311,California
Amador,2021-02-13,162,6548,78,2501,84,4047,0,0,136,4310,26,1137,136,5447,California
Amador,2021-02-14,123,6671,56,2557,67,4114,0,0,107,4401,16,1153,107,5554,California
Amador,2021-02-15,181,6852,59,2616,122,4236,0,0,165,4551,15,1168,165,5719,California
Amador,2021-02-16,401,7253,49,2665,352,4588,0,0,361,4874,40,1208,363,6082,California
Amador,2021-02-17,258,7511,79,2744,179,4767,0,0,165,4947,93,1301,166,6248,California
Amador,2021-02-18,394,7905,99,2843,295,5062,0,0,335,5223,59,1360,335,6583,California
Amador,2021-02-19,181,8086,68,2911,113,5175,0,0,105,5253,76,1436,106,6689,California
Amador,2021-02-20,84,8170,24,2935,60,5235,0,0,60,5289,24,1460,60,6749,California
Amador,2021-02-21,41,8211,31,2966,10,5245,0,0,17,5282,24,1484,17,6766,California
Amador,2021-02-22,63,8274,25,2991,38,5283,0,0,31,5282,31,1515,31,6797,California
Amador,2021-02-23,309,8583,57,3048,252,5535,0,0,130,5241,179,1694,138,6935,California
Amador,2021-02-24,392,8975,51,3099,341,5876,0,0,264,5381,124,1818,264,7199,California
Amador,2021-02-25,505,9480,106,3205,399,6275,0,0,274,5431,229,2047,279,7478,California
Amador,2021-02-26,592,10072,73,3278,519,6794,0,0,494,5830,97,2144,496,7974,California
Amador,2021-02-27,284,10356,88,3366,196,6990,0,0,98,5748,185,2329,103,8077,California
Amador,2021-02-28,94,10450,50,3416,44,7034,0,0,50,5754,44,2373,50,8127,California
Amador,2021-03-01,188,10638,70,3486,118,7152,0,0,122,5812,65,2438,123,8250,California
Amador,2021-03-02,380,11018,62,3548,318,7470,0,0,328,6091,52,2490,331,8581,California
Amador,2021-03-03,216,11234,77,3625,139,7609,0,0,142,6160,74,2564,143,8724,California
Amador,2021-03-04,469,11703,111,3736,358,7967,0,0,369,6438,100,2664,378,9102,California
Amador,2021-03-05,482,12185,63,3799,419,8386,0,0,269,6502,213,2877,277,9379,California
Amador,2021-03-06,90,12275,40,3839,49,8435,1,1,49,6511,41,2918,50,9429,California
Amador,2021-03-07,62,12337,45,3884,17,8452,0,1,18,6485,44,2962,18,9447,California
Amador,2021-03-08,134,12471,72,3956,62,8514,0,1,73,6499,61,3023,75,9522,California
Amador,2021-03-09,372,12843,39,3995,333,8847,0,1,317,6767,52,3075,320,9842,California
Amador,2021-03-10,502,13345,78,4073,423,9270,1,2,232,6746,270,3345,249,10091,California
Amador,2021-03-11,465,13810,115,4188,341,9611,9,11,329,6958,133,3478,345,10436,California
Amador,2021-03-12,542,14352,67,4255,468,10079,7,18,304,7077,237,3715,356,10792,California
Amador,2021-03-13,81,14433,13,4268,61,10140,7,25,29,7079,52,3767,54,10846,California
Amador,2021-03-14,64,14497,21,4289,41,10181,2,27,22,7063,42,3809,26,10872,California
Amador,2021-03-15,179,14676,22,4311,146,10327,11,38,54,7017,125,3934,79,10951,California
Amador,2021-03-16,453,15129,58,4369,391,10718,4,42,195,6964,255,4189,202,11153,California
Amador,2021-03-17,171,15300,33,4402,135,10853,3,45,108,7014,63,4252,113,11266,California
Amador,2021-03-18,132,15432,72,4474,57,10910,3,48,84,7058,47,4299,91,11357,California
Amador,2021-03-19,136,15568,23,4497,106,11016,7,55,74,7080,61,4360,83,11440,California
